Ankave language	aak	3	su:"Ankave language"
Afade language	aal	0	su:"Afade language"
Penobscot language	aaq	25	su:"Penobscot language"
Wawenock language	aaq	1	su:"Wawenock language"
Afar language	aar	53	su:"Afar language"
Abau language	aau	15	su:"Abau language"
Abo (Cameroon) language	abb	0	su:"Abo (Cameroon) language"
Abidji language	abi	14	su:"Abidji language"
Abkhaz language	abk	108	su:"Abkhaz language"
Abung dialect	abl	4	su:"Abung dialect"
Abua language	abn	16	su:"Abua language"
Abazin language	abq	40	su:"Abazin language"
Tapanta language	abq	0	su:"Tapanta language"
Abron language	abr	0	su:"Abron language"
Ambonese Malay language	abs	0	su:"Ambonese Malay language"
Abulas language	abt	35	su:"Abulas language"
Abure language	abu	1	su:"Abure language"
Abaknon language	abx	10	su:"Abaknon language"
Aneme Wake language	aby	2	su:"Aneme Wake language"
Abui language	abz	1	su:"Abui language"
Achagua language	aca	8	su:"Achagua language"
Cubulco Achi language	acc	17	su:"Cubulco Achi language"
Achinese language	ace	91	su:"Achinese language"
Acoli language	ach	52	su:"Acoli language"
Achang language	acn	5	su:"Achang language"
Achi language	acr	56	su:"Achi language"
Achuar language	acu	35	su:"Achuar language"
Achomawi language	acv	14	su:"Achomawi language"
Adangme language	ada	61	su:"Adangme language"
Abor language	adi	28	su:"Abor language"
Bokar language	adi	2	su:"Bokar language"
Milang language	adi	1	su:"Milang language"
Padam language	adi	2	su:"Padam language"
Bori language	adi	1	su:"Bori language"
Pailibo language	adi	0	su:"Pailibo language"
Adyukru language	adj	14	su:"Adyukru language"
Gallong language	adl	6	su:"Gallong language"
Wailpi language	adt	0	su:"Wailpi language"
Amdo language	adx	1	su:"Amdo language"
Adygei language	ady	161	su:"Adygei language"
Chemgui language	ady	0	su:"Chemgui language"
Atsera language	adz	20	su:"Atsera language"
Eastern Arrernte language	aer	12	su:"Eastern Arrernte language"
Alsea language	aes	3	su:"Alsea language"
Amele language	aey	14	su:"Amele language"
Afrihili (Artificial) language	afh	2	su:"Afrihili (Artificial) language"
Afrikaans language	afr	2	su:"Afrikaans language"
Awutu language	afu	2	su:"Awutu language"
Senya language	afu	0	su:"Senya language"
Agarabe language	agd	10	su:"Agarabe language"
Anggor language	agg	11	su:"Anggor language"
Argobba language	agj	5	su:"Argobba language"
Agutaynon language	agn	13	su:"Agutaynon language"
Paranan language	agp	13	su:"Paranan language"
Aghem language	agq	3	su:"Aghem language"
Aguaruna language	agr	7	su:"Aguaruna language"
Agta language	agt	32	su:"Agta language"
Aguacatec language	agu	0	su:"Aguacatec language"
Agul language	agx	12	su:"Agul language"
Ahanta language	aha	2	su:"Ahanta language"
Kemant language	ahg	5	su:"Kemant language"
Quara language	ahg	2	su:"Quara language"
Kaw language	ahk	36	su:"Kaw language"
Igo language	ahl	2	su:"Igo language"
Ahom language	aho	16	su:"Ahom language"
Ahirani language	ahr	0	su:"Ahirani language"
Ahtena language	aht	15	su:"Ahtena language"
Arosi language	aia	33	su:"Arosi language"
Aja (Sudan) language	aja	0	su:"Aja (Sudan) language"
Aja (Benin and Togo) language	ajg	0	su:"Aja (Benin and Togo) language"
Ajie language	aji	26	su:"Ajie language"
Akan language	aka	100	su:"Akan language"
Angkola language	akb	0	su:"Angkola language"
Mpur language (Indonesia)	akc	1	su:"Mpur language (Indonesia)"
Acawai language	ake	9	su:"Acawai language"
Anakalang language	akg	0	su:"Anakalang language"
Angal Heneng language	akh	4	su:"Angal Heneng language"
Akkadian language	akk	2	su:"Akkadian language"
Aklanon language	akl	7	su:"Aklanon language"
Araki language	akr	2	su:"Araki language"
Akhwakh language	akv	4	su:"Akhwakh language"
Alabama language	akz	27	su:"Alabama language"
Mobilian trade language	akz	7	su:"Mobilian trade language"
Alacaluf language	alc	12	su:"Alacaluf language"
Aladian language	ald	3	su:"Aladian language"
Aleut language	ale	199	su:"Aleut language"
Alawa language	alh	34	su:"Alawa language"
Alangan language	alj	7	su:"Alangan language"
Larike-Wakasihu language	alo	2	su:"Larike-Wakasihu language"
Alune language	alp	23	su:"Alune language"
Algonquin language	alq	123	su:"Algonquin language"
Alutor language	alr	6	su:"Alutor language"
Areare language	alu	20	su:"Areare language"
Alyawarra language	aly	25	su:"Alyawarra language"
Alur language	alz	20	su:"Alur language"
Amahuaca language	amc	27	su:"Amahuaca language"
Amuesha language	ame	42	su:"Amuesha language"
Amarag language	amg	0	su:"Amarag language"
Amharic language	amh	853	su:"Amharic language"
Amis language	ami	26	su:"Amis language"
Ambai language	amk	11	su:"Ambai language"
War language	aml	12	su:"War language"
Ama (Papua New Guinea) language	amm	0	su:"Ama (Papua New Guinea) language"
Amanab language	amn	7	su:"Amanab language"
Alamblak language	amp	20	su:"Alamblak language"
Mashco language	amr	20	su:"Mashco language"
Anmatyerre language	amx	12	su:"Anmatyerre language"
Ami language (Australia)	amy	0	su:"Ami language (Australia)"
Angas language	anc	19	su:"Angas language"
Anesu language	ane	6	su:"Anesu language"
Goemai language	ank	1	su:"Goemai language"
Anal language	anm	8	su:"Anal language"
Obolo language	ann	7	su:"Obolo language"
Andoque language	ano	3	su:"Andoque language"
Angika language	anp	8	su:"Angika language"
Anuak language	anu	17	su:"Anuak language"
Abe language	any	3	su:"Abe language"
Anyi language	any	13	su:"Anyi language"
Brissa language	any	1	su:"Brissa language"
Sanwi language	any	0	su:"Sanwi language"
Anem language	anz	1	su:"Anem language"
Arecuna language	aoc	0	su:"Arecuna language"
Camaracoto language	aoc	0	su:"Camaracoto language"
Pemón language	aoc	17	su:"Pemon language"
Taurepan language	aoc	0	su:"Taurepan language"
Magi (Southern Highlands Province, Papua New Guinea) language	aoe	0	su:"Magi (Southern Highlands Province, Papua New Guinea) language"
Andilyaugwa language	aoi	0	su:"Andilyaugwa language"
Southern Arapesh language	aoj	11	su:"Southern Arapesh language"
Aomie language	aom	12	su:"Aomie language"
Saa language	apb	20	su:"Saa language"
Ulawa language	apb	33	su:"Ulawa language"
Mountain Arapesh language	ape	18	su:"Mountain Arapesh language"
Rai language	aph	6	su:"Rai language"
Athpare language	aph	2	su:"Athpare language"
Jicarilla language	apj	15	su:"Jicarilla language"
Chiricahua language	apm	5	su:"Chiricahua language"
Mescalero language	apm	8	su:"Mescalero language"
Apma language	app	12	su:"Apma language"
Arop-Lokep language	apr	5	su:"Arop-Lokep language"
Apatani language	apt	11	su:"Apatani language"
Ipurina language	apu	9	su:"Ipurina language"
White Mountain Apache language	apw	0	su:"White Mountain Apache language"
Western Apache language	apw	12	su:"Western Apache language"
Apalai language	apy	11	su:"Apalai language"
Ampale language	apz	17	su:"Ampale language"
Wojokeso language	apz	0	su:"Wojokeso language"
Archi language	aqc	11	su:"Archi language"
Atakapa language	aqp	9	su:"Atakapa language"
Arabic language	ara	27	su:"Arabic language"
Aramaic language	arc	2	su:"Aramaic language"
Arabana language	ard	2	su:"Arabana language"
Aranda language	are	96	su:"Aranda language"
Aragonese language	arg	7	su:"Aragonese language"
Cheso language	arg	0	su:"Cheso language"
Ica language	arh	11	su:"Ica language"
Arikara language	ari	15	su:"Arikara language"
Arabela language	arl	24	su:"Arabela language"
Ranquel dialect	arn	1	su:"Ranquel dialect"
Mapuche language	arn	226	su:"Mapuche language"
Moluche language	arn	0	su:"Moluche language"
Pehuenche language	arn	1	su:"Pehuenche language"
Araona language	aro	12	su:"Araona language"
Arapaho language	arp	52	su:"Arapaho language"
Karo (Brazil) language	arr	0	su:"Karo (Brazil) language"
Arbore language	arv	1	su:"Arbore language"
Arawak language	arw	58	su:"Arawak language"
Assiniboine language	asb	0	su:"Assiniboine language"
American Sign Language language	ase	42	su:"American Sign Language language"
Australian Sign Language language	asf	0	su:"Australian Sign Language language"
Asilulu language	asl	1	su:"Asilulu language"
Assamese language	asm	196	su:"Assamese language"
Asaro language	aso	10	su:"Asaro language"
Asuri language	asr	1	su:"Asuri language"
Bable language	ast	0	su:"Bable language"
Wasi language	ata	6	su:"Wasi language"
Tsaiwa language	atb	3	su:"Tsaiwa language"
Ata Manobo language	atd	11	su:"Ata Manobo language"
Attie language	ati	12	su:"Attie language"
Atikamekw language	atj	12	su:"Atikamekw language"
Atsina language	ats	3	su:"Atsina language"
Atta language	att	15	su:"Atta language"
Northern Altai language	atv	2	su:"Northern Altai language"
Teleut language	atv	0	su:"Teleut language"
Atsugewi language	atw	8	su:"Atsugewi language"
Aneityum language	aty	63	su:"Aneityum language"
Huao language	auc	10	su:"Huao language"
Sabela language	auc	2	su:"Sabela language"
Anuta language	aud	5	su:"Anuta language"
Aulua language	aul	13	su:"Aulua language"
Avaric language	ava	64	su:"Avaric language"
Avestan language	ave	283	su:"Avestan language"
Avikam language	avi	3	su:"Avikam language"
Au language	avt	15	su:"Au language"
Awadhi language	awa	3	su:"Awadhi language"
Awa (Eastern Highlands Province, Papua New Guinea) language	awb	0	su:"Awa (Eastern Highlands Province, Papua New Guinea) language"
Aekyom language	awi	10	su:"Aekyom language"
Awabakal language	awk	21	su:"Awabakal language"
Agau language	awn	8	su:"Agau language"
Abipon language	axb	4	su:"Abipon language"
Aka (Central African Republic) language	axk	0	su:"Aka (Central African Republic) language"
Armenian, Middle language	axm	0	su:"Armenian, Middle language"
Xaragure language	axx	1	su:"Xaragure language"
Ayizo-gbe language	ayb	1	su:"Ayizo-gbe language"
Aymara language	aym	465	su:"Aymara language"
Moro (South America) language	ayo	0	su:"Moro (South America) language"
Mai Brat language	ayz	9	su:"Mai Brat language"
Afshar language	azb	0	su:"Afshar language"
Azerbaijani language	aze	1	su:"Azerbaijani language"
Bambatana language	baa	17	su:"Bambatana language"
Baré language	bae	2	su:"Bare language"
Bashkir language	bak	484	su:"Bashkir language"
Kuvakan language	bak	0	su:"Kuvakan language"
Baluchi language	bal	105	su:"Baluchi language"
Bambara language	bam	307	su:"Bambara language"
Balinese language	ban	264	su:"Balinese language"
Barasana del Norte language	bao	10	su:"Barasana del Norte language"
Bantawa language	bap	7	su:"Bantawa language"
Basa language	bas	73	su:"Basa language"
Mbili language	baw	2	su:"Mbili language"
Bamun language	bax	26	su:"Bamun language"
Tunen language	baz	4	su:"Tunen language"
Bariba language	bba	15	su:"Bariba language"
Barai language	bbb	45	su:"Barai language"
Toba-Batak language	bbc	2	su:"Toba-Batak language"
Bandjoun language	bbj	16	su:"Bandjoun language"
Bats language	bbl	11	su:"Bats language"
Bobo Fing language	bbo	5	su:"Bobo Fing language"
Gólo language	bbp	3	su:"Golo language"
Bai (China) language	bca	0	su:"Bai (China) language"
Bamu River language	bcf	3	su:"Bamu River language"
Bariai language	bch	10	su:"Bariai language"
Baule language	bci	31	su:"Baule language"
Bardi language	bcj	47	su:"Bardi language"
Bunaba language	bck	1	su:"Bunaba language"
Banoni language	bcm	4	su:"Banoni language"
Kaluli language	bco	5	su:"Kaluli language"
Babine language	bcr	4	su:"Babine language"
Kohumono language	bcs	0	su:"Kohumono language"
Biliau language	bcu	1	su:"Biliau language"
Bacama language	bcy	2	su:"Bacama language"
Basap language	bdb	1	su:"Basap language"
Bunama language	bdd	8	su:"Bunama language"
Bade language	bde	5	su:"Bade language"
Baka language	bdh	15	su:"Baka language"
Budukh language	bdk	3	su:"Budukh language"
Bajau language	bdl	14	su:"Bajau language"
Buduma language	bdm	3	su:"Buduma language"
Bende language	bdp	1	su:"Bende language"
Bahnar language	bdq	42	su:"Bahnar language"
Burunge language	bds	3	su:"Burunge language"
Bakundu language	bdu	0	su:"Bakundu language"
Bankudu-Balue language	bdu	0	su:"Bankudu-Balue language"
Baham language	bdw	2	su:"Baham language"
Yugambeh?Bundjalung dialects	bdy	0	su:"Yugambeh?Bundjalung dialects"
Bandjalang language	bdy	18	su:"Bandjalang language"
Gidabal language	bdy	4	su:"Gidabal language"
Yugumbeh language	bdy	0	su:"Yugumbeh language"
Tsattine language	bea	27	su:"Tsattine language"
Bebele language	beb	1	su:"Bebele language"
Byangsi language	bee	2	su:"Byangsi language"
Benabena language	bef	20	su:"Benabena language"
Biali language	beh	1	su:"Biali language"
Bekati' language	bei	1	su:"Bekati' language"
Beja language	bej	25	su:"Beja language"
Belarusian language	bel	1	su:"Belarusian language"
Bemba language	bem	224	su:"Bemba language"
Bengali language	ben	1	su:"Bengali language"
Bembe (Congo (Brazzaville)) language	beq	0	su:"Bembe (Congo (Brazzaville)) language"
Blagar language	beu	3	su:"Blagar language"
Betawi language	bew	0	su:"Betawi language"
Jur Modo language	bex	1	su:"Jur Modo language"
Kuku language	bfa	0	su:"Kuku language"
Bari language	bfa	29	su:"Bari language"
Bafut language	bfd	8	su:"Bafut language"
British Sign Language language	bfi	3	su:"British Sign Language language"
Bunak language	bfn	6	su:"Bunak language"
Badaga language	bfq	0	su:"Badaga language"
Balti language	bft	10	su:"Balti language"
Bonda language	bfw	4	su:"Bonda language"
Bagheli language	bfy	7	su:"Bagheli language"
Marari language	bfy	0	su:"Marari language"
Bangaru language	bgc	0	su:"Bangaru language"
Deswali language	bgc	0	su:"Deswali language"
Rathvi dialect	bgd	0	su:"Rathvi dialect"
Bugun language	bgg	1	su:"Bugun language"
Bangolan language	bgj	3	su:"Bangolan language"
Bagri language	bgq	0	su:"Bagri language"
Tagabawa Manobo language	bgs	6	su:"Tagabawa Manobo language"
Bugotu language	bgt	46	su:"Bugotu language"
Bhatri dialect	bgw	1	su:"Bhatri dialect"
Banggai language	bgz	4	su:"Banggai language"
Bhili language	bhb	20	su:"Bhili language"
Bhalesi language	bhd	0	su:"Bhalesi language"
Bhadrawahi language	bhd	0	su:"Bhadrawahi language"
Binandere language	bhg	22	su:"Binandere language"
Judeo-Tajik language	bhh	3	su:"Judeo-Tajik language"
Bahing language	bhj	0	su:"Bahing language"
Bhojpuri language	bho	68	su:"Bhojpuri language"
Bimanese language	bhp	18	su:"Bimanese language"
Kolo language	bhp	0	su:"Kolo language"
Binongko language	bhq	1	su:"Binongko language"
Bara (Madagascar) language	bhr	0	su:"Bara (Madagascar) language"
Biak language	bhw	11	su:"Biak language"
Numfor language	bhw	17	su:"Numfor language"
Bada (Indonesia) language	bhz	0	su:"Bada (Indonesia) language"
Bidiyo language	bid	5	su:"Bidiyo language"
Biangai language	big	16	su:"Biangai language"
Bihari language	bih	22	su:"Bihari language"
Bikol language	bik	132	su:"Bikol language"
Bini language	bin	3	su:"Bini language"
Bisorio language	bir	4	su:"Bisorio language"
Bislama language	bis	77	su:"Bislama language"
Birhor language	biy	0	su:"Birhor language"
Barngarla language	bjb	2	su:"Barngarla language"
Bijago language	bjg	4	su:"Bijago language"
Bahinemo language	bjh	6	su:"Bahinemo language"
Burji language	bji	2	su:"Burji language"
Kanauji language	bjj	0	su:"Kanauji language"
Banjarese language	bjn	23	su:"Banjarese language"
Banjar Hulu language	bjn	1	su:"Banjar Hulu language"
Antaisaka language	bjq	0	su:"Antaisaka language"
Betsimisaraka language	bjq	1	su:"Betsimisaraka language"
Binumarien language	bjr	12	su:"Binumarien language"
Bakwé language	bjw	4	su:"Bakwe language"
Southern Bontoc language	bkb	0	su:"Southern Bontoc language"
Eastern Bontoc language	bkb	0	su:"Eastern Bontoc language"
Baka (Cameroon and Gabon) language	bkc	0	su:"Baka (Cameroon and Gabon) language"
Binukid Manobo language	bkd	25	su:"Binukid Manobo language"
Baki language	bki	12	su:"Baki language"
Brokpa language	bkk	0	su:"Brokpa language"
Berik language	bkl	24	su:"Berik language"
Kom (Cameroon) language	bkm	0	su:"Kom (Cameroon) language"
Bakairi language	bkq	20	su:"Bakairi language"
Bakumpai language	bkr	2	su:"Bakumpai language"
Bekwarra language	bkv	15	su:"Bekwarra language"
Timor language	bkx	34	su:"Timor language"
Bungku language	bkz	7	su:"Bungku language"
Siksika language	bla	130	su:"Siksika language"
Bella Coola language	blc	9	su:"Bella Coola language"
Atinggola language	bld	5	su:"Atinggola language"
Uki language	bld	0	su:"Uki language"
Balante language	ble	12	su:"Balante language"
Buol language	blf	5	su:"Buol language"
Bolia language	bli	3	su:"Bolia language"
Bolongan language	blj	4	su:"Bolongan language"
Taungthu language	blk	3	su:"Taungthu language"
Biloxi language	bll	8	su:"Biloxi language"
Blang language	blr	6	su:"Blang language"
Balaesang language	bls	1	su:"Balaesang language"
Black Tai language	blt	8	su:"Black Tai language"
Balangao language	blw	40	su:"Balangao language"
Ayta Mag Indi language	blx	0	su:"Ayta Mag Indi language"
Balantak language	blz	8	su:"Balantak language"
Bembe (Lake Tanganyika) language	bmb	0	su:"Bembe (Lake Tanganyika) language"
Bagirmi language	bmi	4	su:"Bagirmi language"
Bote-Mahi language	bmj	1	su:"Bote-Mahi language"
Boomu language	bmq	0	su:"Boomu language"
Muinane language	bmr	17	su:"Muinane language"
Burum (Papua New Guinea) language	bmu	0	su:"Burum (Papua New Guinea) language"
Central Bontoc language	bnc	1	su:"Central Bontoc language"
Banda (Indonesia) language	bnd	0	su:"Banda (Indonesia) language"
Bintauna language	bne	1	su:"Bintauna language"
Benga language	bng	28	su:"Benga language"
Bobangi language	bni	57	su:"Bobangi language"
Bunun language	bnn	15	su:"Bunun language"
Banton language	bno	7	su:"Banton language"
Bundeli language	bns	2	su:"Bundeli language"
Pawari language	bns	0	su:"Pawari language"
Bangubangu language	bnx	2	su:"Bangubangu language"
Bora language	boa	24	su:"Bora language"
Boni (Kenya and Somalia) language	bob	0	su:"Boni (Kenya and Somalia) language"
Tibetan language	bod	3	su:"Tibetan language"
Boma (Congo) language	boh	0	su:"Boma (Congo) language"
Bom language	boj	16	su:"Bom language"
Bole language	bol	4	su:"Bole language"
Birom language	bom	19	su:"Birom language"
Bororo (Brazil) language	bor	0	su:"Bororo (Brazil) language"
Bosnian language	bos	162	su:"Bosnian language"
Bongo language	bot	3	su:"Bongo language"
Bondei language	bou	9	su:"Bondei language"
Botlikh language	bph	1	su:"Botlikh language"
Kaure language	bpp	8	su:"Kaure language"
Koronadal Blaan language	bpr	1	su:"Koronadal Blaan language"
Bongu language	bpu	4	su:"Bongu language"
Bishnupuriya language	bpy	0	su:"Bishnupuriya language"
Baima language	bqh	1	su:"Baima language"
Bakhtiari language	bqi	29	su:"Bakhtiari language"
Mkaa' language	bqz	0	su:"Mkaa' language"
Braj language	bra	80	su:"Braj language"
Baram language	brd	2	su:"Baram language"
Breton language	bre	926	su:"Breton language"
Bauré language	brg	18	su:"Baure language"
Brahui language	brh	60	su:"Brahui language"
Kwiri language	bri	7	su:"Kwiri language"
Barambu language	brm	1	su:"Barambu language"
Boruca language	brn	10	su:"Boruca language"
Tutong language	bsb	3	su:"Tutong language"
Bassari language	bsc	9	su:"Bassari language"
Bashgali language	bsh	8	su:"Bashgali language"
Burushaski language	bsk	34	su:"Burushaski language"
Werchikwar language	bsk	0	su:"Werchikwar language"
Barasana del Sur language	bsn	19	su:"Barasana del Sur language"
Taiwano language	bsn	0	su:"Taiwano language"
Bassa (Liberia and Sierra Leone) language	bsq	0	su:"Bassa (Liberia and Sierra Leone) language"
Bakossi language	bss	0	su:"Bakossi language"
Basketo language	bst	0	su:"Basketo language"
Baiso language	bsw	1	su:"Baiso language"
Dii language	bta	8	su:"Dii language"
Bati language	btc	4	su:"Bati language"
Dairi Pakpak language	btd	0	su:"Dairi Pakpak language"
Biatah language	bth	0	su:"Biatah language"
Simelungun language	bts	0	su:"Simelungun language"
Karo-Batak language	btx	8	su:"Karo-Batak language"
Alas language	btz	4	su:"Alas language"
Kluet language	btz	3	su:"Kluet language"
Buriat language	bua	248	su:"Buriat language"
Tobote language	bud	2	su:"Tobote language"
Beothuk language	bue	15	su:"Beothuk language"
Bushoong language	buf	7	su:"Bushoong language"
Bugis language	bug	154	su:"Bugis language"
Bukawa language	buk	3	su:"Bukawa language"
Bulgarian language	bul	2	su:"Bulgarian language"
Bulu language	bum	63	su:"Bulu language"
Sherbro language	bun	3	su:"Sherbro language"
Buin language	buo	23	su:"Buin language"
Budu language	buu	2	su:"Budu language"
Bubi language (Gabon)	buw	1	su:"Bubi language (Gabon)"
Northern Bullom language	buy	7	su:"Northern Bullom language"
Bube language	bvb	13	su:"Bube language"
Birri language	bvq	1	su:"Birri language"
Burarra language	bvr	230	su:"Burarra language"
Meratus language	bvu	0	su:"Meratus language"
Bauzi language	bvz	15	su:"Bauzi language"
Bwaidoga language	bwd	11	su:"Bwaidoga language"
Rue language	bwg	1	su:"Rue language"
Baniwa language	bwi	7	su:"Baniwa language"
Balong language	bwt	0	su:"Balong language"
Buli language	bwu	18	su:"Buli language"
Benge language	bww	4	su:"Benge language"
Bwamu language	bww	23	su:"Bwamu language"
Bor (Lwo) language	bxb	0	su:"Bor (Lwo) language"
Ongota language	bxe	2	su:"Ongota language"
Bayungu language	bxj	4	su:"Bayungu language"
Bukusu language	bxk	2	su:"Bukusu language"
Batak language	bya	169	su:"Batak language"
Batak (Philippines) language	bya	0	su:"Batak (Philippines) language"
Bete language	byf	28	su:"Bete language"
Bidjara language	bym	1	su:"Bidjara language"
Bilin language	byn	10	su:"Bilin language"
Baruya language	byr	32	su:"Baruya language"
Medumba language	byv	5	su:"Medumba language"
Baining language	byx	12	su:"Baining language"
Gbandi language	bza	17	su:"Gbandi language"
Bribri language	bzd	0	su:"Bribri language"
Boiken language	bzf	15	su:"Boiken language"
Yangoru language	bzf	3	su:"Yangoru language"
Favorlang language	bzg	4	su:"Favorlang language"
Biri (Australia) language	bzr	0	su:"Biri (Australia) language"
Chorti language	caa	51	su:"Chorti language"
Black Carib language	cab	1	su:"Black Carib language"
Caddo language	cad	7	su:"Caddo language"
Chulupí language	cag	17	su:"Chulupi language"
Carolinian language	cal	11	su:"Carolinian language"
Camuhi language	cam	12	su:"Camuhi language"
Chambri language	can	1	su:"Chambri language"
Chacobo language	cao	27	su:"Chacobo language"
Chipaya language	cap	27	su:"Chipaya language"
Car Nicobarese language	caq	10	su:"Car Nicobarese language"
Carib language	car	119	su:"Carib language"
Chimane language	cas	7	su:"Chimane language"
Moseten language	cas	5	su:"Moseten language"
Catalan language	cat	3	su:"Catalan language"
Cavineño language	cav	34	su:"Cavineno language"
Callahuaya language	caw	12	su:"Callahuaya language"
Chiquito language	cax	30	su:"Chiquito language"
Cayuga language	cay	19	su:"Cayuga language"
Canichana language	caz	0	su:"Canichana language"
Carapana (Tucanoan) language	cbc	0	su:"Carapana (Tucanoan) language"
Cayapa language	cbi	10	su:"Cayapa language"
Chabacano language	cbk	30	su:"Chabacano language"
Nyah Kur language	cbn	3	su:"Nyah Kur language"
Cashibo language	cbr	26	su:"Cashibo language"
Cashinawa language	cbs	22	su:"Cashinawa language"
Chayahuita language	cbt	40	su:"Chayahuita language"
Candoshi language	cbu	30	su:"Candoshi language"
Cacua language	cbv	6	su:"Cacua language"
Chamicuro language	ccc	5	su:"Chamicuro language"
Chopi language	cce	16	su:"Chopi language"
Chamba Daka language	ccg	6	su:"Chamba Daka language"
Chakma language	ccp	12	su:"Chakma language"
Chambiali language	cdh	1	su:"Chambiali language"
Chepang language	cdm	8	su:"Chepang language"
Cebuano language	ceb	251	su:"Cebuano language"
Chamacoco language	ceg	4	su:"Chamacoco language"
Czech language	ces	6	su:"Czech language"
Laizo (Burma) language	cfm	0	su:"Laizo (Burma) language"
Falam Chin language	cfm	6	su:"Falam Chin language"
Kagayanen language	cgc	15	su:"Kagayanen language"
Chiga language	cgg	1	su:"Chiga language"
Chamorro language	cha	191	su:"Chamorro language"
Chibcha language	chb	42	su:"Chibcha language"
Catawba language	chc	16	su:"Catawba language"
Akka language	che	0	su:"Akka language"
Chechen language	che	83	su:"Chechen language"
Chagatai language	chg	100	su:"Chagatai language"
Chinook language	chh	97	su:"Chinook language"
Cahuilla language	chl	22	su:"Cahuilla language"
Choctaw language	cho	235	su:"Choctaw language"
Chipewyan language	chp	136	su:"Chipewyan language"
Cherokee language	chr	460	su:"Cherokee language"
Chumash language	chs	25	su:"Chumash language"
Cholon language	cht	3	su:"Cholon language"
Church Slavic language	chu	2	su:"Church Slavic language"
Chuvash language	chv	445	su:"Chuvash language"
Chuwabo language	chw	2	su:"Chuwabo language"
Chantel language	chx	2	su:"Chantel language"
Cheyenne language	chy	64	su:"Cheyenne language"
Ozumacín language	chz	0	su:"Ozumacin language"
Cia-cia language	cia	1	su:"Cia-cia language"
Chickasaw language	cic	18	su:"Chickasaw language"
Chimariko language	cid	5	su:"Chimariko language"
Chinali language	cih	1	su:"Chinali language"
Cimbrian language	cim	17	su:"Cimbrian language"
Chiapanec language	cip	27	su:"Chiapanec language"
Tinrin language	cir	3	su:"Tinrin language"
Amikwa language	ciw	0	su:"Amikwa language"
Upper Chehalis language	cjh	5	su:"Upper Chehalis language"
Chamalal language	cji	2	su:"Chamalal language"
Chokwe language	cjk	44	su:"Chokwe language"
Cabecar language	cjp	12	su:"Cabecar language"
Mangue language	cjr	12	su:"Mangue language"
Shor language	cjs	18	su:"Shor language"
Chuave language	cjv	8	su:"Chuave language"
Khumi Awa language	cka	0	su:"Khumi Awa language"
Mukri language	ckb	0	su:"Mukri language"
Anufo language	cko	0	su:"Anufo language"
Tayo language	cks	1	su:"Tayo language"
Chukchi language	ckt	80	su:"Chukchi language"
Koasati language	cku	11	su:"Koasati language"
Ron language	cla	2	su:"Ron language"
Idu language	clk	9	su:"Idu language"
Mishmi language	clk	7	su:"Mishmi language"
Clallam language	clm	11	su:"Clallam language"
Caluyanun language	clu	10	su:"Caluyanun language"
Maa (Vietnam) language	cma	0	su:"Maa (Vietnam) language"
Maa (Southeastern Asia) language	cma	0	su:"Maa (Southeastern Asia) language"
Chamí language	cmi	4	su:"Chami language"
Biat language	cmo	0	su:"Biat language"
Central Mnong language	cmo	0	su:"Central Mnong language"
Messapian language	cms	10	su:"Messapian language"
Chinbon language	cnb	1	su:"Chinbon language"
Haka Chin language	cnh	18	su:"Haka Chin language"
Campa language	cni	68	su:"Campa language"
Khumi language	cnk	5	su:"Khumi language"
Ahraing Khumi language	cnk	0	su:"Ahraing Khumi language"
Ngaun language	cnw	3	su:"Ngaun language"
Cocopa language	coc	15	su:"Cocopa language"
Cocama language	cod	17	su:"Cocama language"
Coreguaje language	coe	27	su:"Coreguaje language"
Colorado language	cof	66	su:"Colorado language"
Kumiai language	coj	7	su:"Kumiai language"
Comanche language	com	37	su:"Comanche language"
Cofán language	con	14	su:"Cofan language"
Akhmimic dialect	cop	1	su:"Akhmimic dialect"
Bohairic language	cop	0	su:"Bohairic language"
Coptic language	cop	994	su:"Coptic language"
Sahidic language	cop	1	su:"Sahidic language"
Coquille language	coq	3	su:"Coquille language"
Cornish language	cor	308	su:"Cornish language"
Corsican language	cos	13	su:"Corsican language"
Caquinte language	cot	9	su:"Caquinte language"
Chocho language	coz	14	su:"Chocho language"
Island Carib language	crb	15	su:"Island Carib language"
Lonwolwol language	crc	10	su:"Lonwolwol language"
Cree language	cre	1	su:"Cree language"
Michif language	crg	48	su:"Michif language"
Crimean Tatar language	crh	82	su:"Crimean Tatar language"
Cora language	crn	37	su:"Cora language"
Crow language	cro	78	su:"Crow language"
Choroti language	crt	19	su:"Choroti language"
Chrau language	crw	52	su:"Chrau language"
Carrier language	crx	85	su:"Carrier language"
Kashubian language	csb	123	su:"Kashubian language"
Slovincian language	csb	1	su:"Slovincian language"
Chilean Sign Language language	csg	0	su:"Chilean Sign Language language"
Khyang language	csh	12	su:"Khyang language"
Bodega Miwok language	csi	1	su:"Bodega Miwok language"
Diola Kasa language	csk	3	su:"Diola Kasa language"
Esuulaalu language	csk	0	su:"Esuulaalu language"
Chinese Sign Language language	csl	1	su:"Chinese Sign Language language"
Costa Rican Sign Language language	csr	0	su:"Costa Rican Sign Language language"
Mutsun language	css	2	su:"Mutsun language"
Siyin language	csy	9	su:"Siyin language"
Coos language	csz	10	su:"Coos language"
Tiddim Chin language	ctd	0	su:"Tiddim Chin language"
Chitimacha language	ctm	7	su:"Chitimacha language"
Catio language	cto	18	su:"Catio language"
Cua language	cua	10	su:"Cua language"
Cubeo language	cub	36	su:"Cubeo language"
Cuiba language	cui	19	su:"Cuiba language"
Sicuane language	cui	0	su:"Sicuane language"
Chontaquiro language	cuj	11	su:"Chontaquiro language"
Cuna language	cuk	85	su:"Cuna language"
Cueva language	cuk	1	su:"Cueva language"
Culina language	cul	18	su:"Culina language"
Cupeño language	cup	10	su:"Cupeno language"
Ya language	cuu	99	su:"Ya language"
Kwatay language	cwt	2	su:"Kwatay language"
Cayuvava language	cyb	9	su:"Cayuvava language"
Welsh language	cym	6	su:"Welsh language"
Cuyunon language	cyo	11	su:"Cuyunon language"
Zotung language	czt	0	su:"Zotung language"
Dangaleat language	daa	18	su:"Dangaleat language"
Ham language	dad	2	su:"Ham language"
Dan language	daf	58	su:"Dan language"
Dagbani language	dag	47	su:"Dagbani language"
Day (Chad) language	dai	0	su:"Day (Chad) language"
Dakota language	dak	620	su:"Dakota language"
Santee language	dak	0	su:"Santee language"
Yankton language	dak	0	su:"Yankton language"
Dahalo language	dal	2	su:"Dahalo language"
Danish language	dan	3	su:"Danish language"
Dafla language	dap	9	su:"Dafla language"
Tagin language	dap	1	su:"Tagin language"
Dargwa language	dar	36	su:"Dargwa language"
Kubachi language	dar	0	su:"Kubachi language"
Dabida language	dav	0	su:"Dabida language"
Taita language	dav	12	su:"Taita language"
Edopi language	dbf	2	su:"Edopi language"
Begak language	dbj	0	su:"Begak language"
Djirbal language	dbl	8	su:"Djirbal language"
Daba language	dbq	19	su:"Daba language"
Dakhini language	dcc	52	su:"Dakhini language"
Fataluku language	ddg	2	su:"Fataluku language"
Djaru language	ddj	29	su:"Djaru language"
Dendi language	ddn	0	su:"Dendi language"
Dido language	ddo	6	su:"Dido language"
Dedua language	ded	9	su:"Dedua language"
Degema language	deg	10	su:"Degema language"
Delaware language	del	155	su:"Delaware language"
Chutiya language	der	0	su:"Chutiya language"
Desana language	des	23	su:"Desana language"
German language	deu	74	su:"German language"
Dengese language	dez	1	su:"Dengese language"
Dumagat (Casiguran) language	dgc	0	su:"Dumagat (Casiguran) language"
Wule language	dgi	0	su:"Wule language"
Dogri language	dgo	6	su:"Dogri language"
Dogrib language	dgr	15	su:"Dogrib language"
Daga language	dgz	14	su:"Daga language"
Jaipuri language	dhd	0	su:"Jaipuri language"
Wan'guri language	dhg	2	su:"Wan'guri language"
Dhimal language	dhi	5	su:"Dhimal language"
Dhalandji language	dhl	1	su:"Dhalandji language"
Himba language	dhm	0	su:"Himba language"
Dhodia language	dho	0	su:"Dhodia language"
Dargari language	dhr	0	su:"Dargari language"
Dhurga language	dhu	12	su:"Dhurga language"
Dehu language	dhv	41	su:"Dehu language"
Danuwar Rai language	dhw	4	su:"Danuwar Rai language"
Vata language	dic	2	su:"Vata language"
Diyari language	dif	14	su:"Diyari language"
Digo language	dig	10	su:"Digo language"
Li language	dij	27	su:"Li language"
Dinka language	din	46	su:"Dinka language"
Padang language	dip	2	su:"Padang language"
Dimasa language	dis	11	su:"Dimasa language"
Diriku language	diu	15	su:"Diriku language"
Divehi language	div	22	su:"Divehi language"
Ding language	diz	1	su:"Ding language"
Ngaliwuru language	djd	9	su:"Ngaliwuru language"
Zarma language	dje	2	su:"Zarma language"
Djinang language	dji	12	su:"Djinang language"
Ndjebbana language	djj	243	su:"Ndjebbana language"
Djuka language	djk	25	su:"Djuka language"
Boni (French Guiana and Suriname) language	djk	0	su:"Boni (French Guiana and Suriname) language"
Jamsay dialect	djm	1	su:"Jamsay dialect"
Bor (Dinka) language	dks	0	su:"Bor (Dinka) language"
Dolgan language	dlg	13	su:"Dolgan language"
Dalmatian (Romance) language	dlm	0	su:"Dalmatian (Romance) language"
Vegliote language	dlm	0	su:"Vegliote language"
Aduma language	dma	3	su:"Aduma language"
Domaaki language	dmk	1	su:"Domaaki language"
Dampelasa language	dms	1	su:"Dampelasa language"
Dungan language	dng	44	su:"Dungan language"
Western Dani language	dnw	4	su:"Western Dani language"
Dobu language	dob	79	su:"Dobu language"
Dompago language	dop	2	su:"Dompago language"
Doyayo language	dow	1	su:"Doyayo language"
Gedeo language	drs	3	su:"Gedeo language"
Badakhshani language	drw	0	su:"Badakhshani language"
Darai language	dry	4	su:"Darai language"
Lower Sorbian language	dsb	58	su:"Lower Sorbian language"
Dutch Sign language	dse	15	su:"Dutch Sign language"
Danish Sign Language language	dsl	0	su:"Danish Sign Language language"
Dagur language	dta	50	su:"Dagur language"
Duala language	dua	68	su:"Duala language"
Duna language	duc	12	su:"Duna language"
Dukawa language	dud	1	su:"Dukawa language"
Dumagat (Umirey) language	due	0	su:"Dumagat (Umirey) language"
Dumbea language	duf	6	su:"Dumbea language"
Duruma language	dug	10	su:"Duruma language"
Dungra Bhil language	duh	0	su:"Dungra Bhil language"
Djapu language	duj	37	su:"Djapu language"
Dusun Deyah language	dun	1	su:"Dusun Deyah language"
Dupaninan Agta language	duo	3	su:"Dupaninan Agta language"
Dumi language	dus	2	su:"Dumi language"
Tulung language	duu	3	su:"Tulung language"
Dawawa language	dww	4	su:"Dawawa language"
Dyan language	dya	2	su:"Dyan language"
Djimini language	dyi	5	su:"Djimini language"
Diola language	dyu	37	su:"Diola language"
Dyula language	dyu	85	su:"Dyula language"
Daza language	dzd	0	su:"Daza language"
Dzongkha language	dzo	38	su:"Dzongkha language"
Embu language	ebu	5	su:"Embu language"
Eteocretan language	ecr	6	su:"Eteocretan language"
Efik language	efi	86	su:"Efik language"
Eggon language	ego	7	su:"Eggon language"
Egyptian language	egy	5	su:"Egyptian language"
Eipo language	eip	3	su:"Eipo language"
Ekajuk language	eka	30	su:"Ekajuk language"
Kapauku language	ekg	16	su:"Kapauku language"
Koti language	eko	1	su:"Koti language"
Ekpeye language	ekp	5	su:"Ekpeye language"
Elamite language	elx	68	su:"Elamite language"
Embaloh language	emb	8	su:"Embaloh language"
Emerillon language	eme	2	su:"Emerillon language"
Mascoi language	emo	2	su:"Mascoi language"
Koniagmiut language	ems	0	su:"Koniagmiut language"
Pacific Gulf Yupik language	ems	17	su:"Pacific Gulf Yupik language"
Chugach language	ems	0	su:"Chugach language"
English language	eng	347	su:"English language"
Engenni language	enn	15	su:"Engenni language"
Enggano language	eno	4	su:"Enggano language"
Enga language	enq	34	su:"Enga language"
Oron language	enw	2	su:"Oron language"
Atisa language	epi	5	su:"Atisa language"
Eromanga language	erg	36	su:"Eromanga language"
South Efate language	erk	8	su:"South Efate language"
Erre language	err	5	su:"Erre language"
Ese Ejja language	ese	31	su:"Ese Ejja language"
Esselen language	esq	3	su:"Esselen language"
Yuit language	ess	70	su:"Yuit language"
Estonian language	est	1	su:"Estonian language"
Setu language	est	0	su:"Setu language"
Mulgi language	est	0	su:"Mulgi language"
Karksi language	est	0	su:"Karksi language"
Aglemiut language	esu	0	su:"Aglemiut language"
Central Yupik language	esu	53	su:"Central Yupik language"
Eton language	eto	3	su:"Eton language"
Edolo language	etr	4	su:"Edolo language"
Etsako language	ets	2	su:"Etsako language"
Etruscan language	ett	478	su:"Etruscan language"
Ejagham language	etu	12	su:"Ejagham language"
Basque language	eus	2	su:"Basque language"
Even language	eve	49	su:"Even language"
Evenki language	evn	117	su:"Evenki language"
Solon language	evn	0	su:"Solon language"
Ewe language	ewe	286	su:"Ewe language"
Ewondo language	ewo	60	su:"Ewondo language"
Eyak language	eya	14	su:"Eyak language"
Fasu language	faa	22	su:"Fasu language"
Annobon language	fab	0	su:"Annobon language"
Faiwol language	fai	25	su:"Faiwol language"
Fang language	fan	36	su:"Fang language"
Faroese language	fao	147	su:"Faroese language"
Falor language	fap	1	su:"Falor language"
Persian language	fas	7	su:"Persian language"
Fanti language	fat	124	su:"Fanti language"
Quebec Sign language	fcs	14	su:"Quebec Sign language"
Mahas-Fiyadikka language	fia	4	su:"Mahas-Fiyadikka language"
Fijian language	fij	544	su:"Fijian language"
Filipino language	fil	98	su:"Filipino language"
Finnish language	fin	2	su:"Finnish language"
Izere language	fiz	1	su:"Izere language"
Kalispel language	fla	61	su:"Kalispel language"
Fali language	fli	5	su:"Fali language"
Kifuliru language	flr	0	su:"Kifuliru language"
Fuliru language	flr	10	su:"Fuliru language"
Fe'fe' language	fmp	22	su:"Fe'fe' language"
Foi language	foi	3	su:"Foi language"
Fon language	fon	2	su:"Fon language"
Fore language	for	21	su:"Fore language"
French language	fra	99	su:"French language"
Cajun French language	frc	0	su:"Cajun French language"
Fordata language	frd	6	su:"Fordata language"
Vaudois language	frp	0	su:"Vaudois language"
Futuna language	fud	18	su:"Futuna language"
Pular language	fuf	4	su:"Pular language"
Fula language	ful	442	su:"Fula language"
Fulnio language	fun	8	su:"Fulnio language"
Friulian language	fur	1	su:"Friulian language"
Futuna-Aniwa language	fut	29	su:"Futuna-Aniwa language"
Furu language	fuu	1	su:"Furu language"
Bororo (West Africa) language	fuv	0	su:"Bororo (West Africa) language"
Fuyuge language	fuy	9	su:"Fuyuge language"
Fur language	fvr	7	su:"Fur language"
Gã language	gaa	162	su:"Ga language"
Gabri language	gab	6	su:"Gabri language"
Gaddang language	gad	27	su:"Gaddang language"
Arekena language	gae	1	su:"Arekena language"
Gagauz language	gag	39	su:"Gagauz language"
Gahuku language	gah	27	su:"Gahuku language"
Gadsup language	gaj	17	su:"Gadsup language"
Galoli language	gal	3	su:"Galoli language"
Gata' language	gaq	3	su:"Gata' language"
Adiwasi Garasia language	gas	0	su:"Adiwasi Garasia language"
Gadaba (Dravidian) language	gau	0	su:"Gadaba (Dravidian) language"
Halopa language	gaw	3	su:"Halopa language"
Boran language	gax	0	su:"Boran language"
Gayo language	gay	18	su:"Gayo language"
Gbaya language	gba	52	su:"Gbaya language"
Kaytetye language	gbb	10	su:"Kaytetye language"
Garawa language	gbc	52	su:"Garawa language"
Sawos language	gbf	3	su:"Sawos language"
Galela language	gbi	28	su:"Galela language"
Gadaba (Munda) language	gbj	0	su:"Gadaba (Munda) language"
Gadi language	gbk	0	su:"Gadi language"
Gamit language	gbl	0	su:"Gamit language"
Garhwali language	gbm	2	su:"Garhwali language"
Parvati language	gbm	0	su:"Parvati language"
Gbagyi language	gbr	4	su:"Gbagyi language"
Gagadu language	gbu	2	su:"Gagadu language"
Gbari language	gby	7	su:"Gbari language"
Gedaged language	gdd	41	su:"Gedaged language"
Gude language	gde	15	su:"Gude language"
Yaghwatadaxa language	gdf	0	su:"Yaghwatadaxa language"
Laal language	gdm	1	su:"Laal language"
Gwedena language	gdn	8	su:"Gwedena language"
Godoberi language	gdo	3	su:"Godoberi language"
Mahri language	gdq	22	su:"Mahri language"
Gade language	ged	3	su:"Gade language"
Gen-Gbe language	gej	0	su:"Gen-Gbe language"
Enya language	gey	1	su:"Enya language"
Ethiopic language	gez	409	su:"Ethiopic language"
Pala language	gfk	29	su:"Pala language"
Gafat language	gft	5	su:"Gafat language"
Gagu language	ggu	7	su:"Gagu language"
Gogodala language	ggw	18	su:"Gogodala language"
Guhu-Samane language	ghs	11	su:"Guhu-Samane language"
Kitja language	gia	4	su:"Kitja language"
Gidar language	gid	2	su:"Gidar language"
Gilbertese language	gil	339	su:"Gilbertese language"
Gimi language	gim	33	su:"Gimi language"
Ginukh language	gin	2	su:"Ginukh language"
Gonja language	gjn	23	su:"Gonja language"
Gujuri language	gju	14	su:"Gujuri language"
Gokana language	gkn	2	su:"Gokana language"
Nanai language	gld	53	su:"Nanai language"
Irish language	gle	3	su:"Irish language"
Galician language	glg	658	su:"Galician language"
Kùláál language	glj	3	su:"Kulaal language"
Gilaki language	glk	33	su:"Gilaki language"
Glosa (Artificial) language	gls	22	su:"Glosa (Artificial) language"
Manx language	glv	181	su:"Manx language"
Glavda language	glw	2	su:"Glavda language"
Gamo language	gmo	5	su:"Gamo language"
Gangte language	gnb	6	su:"Gangte language"
Guanche language	gnc	23	su:"Guanche language"
Zulgo language	gnd	8	su:"Zulgo language"
Mi Gangam language	gng	3	su:"Mi Gangam language"
Lyele language	gnh	9	su:"Lyele language"
Gunian language	gni	28	su:"Gunian language"
G//ana language	gnk	1	su:"G//ana language"
Gumatj language	gnn	317	su:"Gumatj language"
Gureng Gureng language	gnr	2	su:"Gureng Gureng language"
Kweni language	goa	12	su:"Kweni language"
Dadjriwale? dialect	god	1	su:"Dadjriwale? dialect"
Godie? language	god	3	su:"Godie? language"
Gogo language	gog	26	su:"Gogo language"
Gola language	gol	10	su:"Gola language"
Chitapavani language	gom	0	su:"Chitapavani language"
Kudali language	gom	0	su:"Kudali language"
Gondi language	gon	34	su:"Gondi language"
Gorontalo language	gor	51	su:"Gorontalo language"
Tilamuta language	gor	0	su:"Tilamuta language"
Gothic language	got	657	su:"Gothic language"
Grebo language	grb	41	su:"Grebo language"
Greek language	grc	25	su:"Greek language"
Attic Greek language	grc	14	su:"Attic Greek language"
Doric Greek language	grc	1	su:"Doric Greek language"
Ionic Greek language	grc	6	su:"Ionic Greek language"
Aeolic Greek language	grc	2	su:"Aeolic Greek language"
Ma language	grg	13	su:"Ma language"
Vaturanga language	gri	13	su:"Vaturanga language"
Jabo language	grj	5	su:"Jabo language"
Guarani language	grn	539	su:"Guarani language"
Garo language	grt	39	su:"Garo language"
Goajiro language	guc	67	su:"Goajiro language"
Gupapuyngu language	guf	365	su:"Gupapuyngu language"
Guahibo language	guh	44	su:"Guahibo language"
Chiriguano language	gui	15	su:"Chiriguano language"
Gujarati language	guj	1	su:"Gujarati language"
Parsi-Gujarati language	guj	0	su:"Parsi-Gujarati language"
Sea Islands Creole language	gul	0	su:"Sea Islands Creole language"
Moguex language	gum	13	su:"Moguex language"
Mbya language	gun	14	su:"Mbya language"
Guayabero language	guo	10	su:"Guayabero language"
Gunwinggu language	gup	32	su:"Gunwinggu language"
Guayaki language	guq	8	su:"Guayaki language"
Frafra language	gur	14	su:"Frafra language"
Guatuso language	gut	5	su:"Guatuso language"
Yanomamo language	guu	41	su:"Yanomamo language"
Gun-Gbe language	guw	3	su:"Gun-Gbe language"
Gurma language	gux	34	su:"Gurma language"
Gusii language	guz	24	su:"Gusii language"
Guanano language	gvc	16	su:"Guanano language"
Golin language	gvf	3	su:"Golin language"
Marigl language	gvf	0	su:"Marigl language"
Kuku-Yalanji language	gvn	34	su:"Kuku-Yalanji language"
Zoró language	gvo	1	su:"Zoro language"
Tamu language	gvr	1	su:"Tamu language"
Gumasi language	gvs	2	su:"Gumasi language"
Gwich'in language	gwi	70	su:"Gwich'in language"
G/wi language	gwj	2	su:"G/wi language"
Gwandara language	gwn	3	su:"Gwandara language"
Gwere language	gwr	1	su:"Gwere language"
Gwa (Ghana) language	gwx	0	su:"Gwa (Ghana) language"
Yaayuwee language	gya	0	su:"Yaayuwee language"
Gayardilt language	gyd	3	su:"Gayardilt language"
Gungabula language	gyf	3	su:"Gungabula language"
Bagyele language	gyi	1	su:"Bagyele language"
Guaymi language	gym	34	su:"Guaymi language"
Guarayo language	gyr	18	su:"Guarayo language"
Gorani language	hac	9	su:"Gorani language"
Hatam language	had	4	su:"Hatam language"
Qottu language	hae	0	su:"Qottu language"
Hanga (Ghana) language	hag	0	su:"Hanga (Ghana) language"
Haida language	hai	120	su:"Haida language"
Hangaza language	han	1	su:"Hangaza language"
Ha language	haq	6	su:"Ha language"
Harari language	har	28	su:"Harari language"
Haisla language	has	4	su:"Haisla language"
Hausa language	hau	2	su:"Hausa language"
Uwana language	hau	0	su:"Uwana language"
Hawaiian language	haw	1	su:"Hawaiian language"
Haya language	hay	20	su:"Haya language"
Hazara language	haz	5	su:"Hazara language"
Serbo-Croatian language	hbs	3	su:"Serbo-Croatian language"
Huichol language	hch	49	su:"Huichol language"
Hadiya language	hdy	3	su:"Hadiya language"
Black Hmong language	hea	0	su:"Black Hmong language"
Hehe language	heh	1	su:"Hehe language"
Heiltsuk language	hei	4	su:"Heiltsuk language"
Oowekyala language	hei	2	su:"Oowekyala language"
Herero language	her	79	su:"Herero language"
Laamang language	hia	5	su:"Laamang language"
Hidatsa language	hid	36	su:"Hidatsa language"
Fiji Hindi language	hif	10	su:"Fiji Hindi language"
Kamwe language	hig	8	su:"Kamwe language"
Hiligaynon language	hil	91	su:"Hiligaynon language"
Himachali language	him	12	su:"Himachali language"
Hindi language	hin	7	su:"Hindi language"
Khari Boli language	hin	15	su:"Khari Boli language"
Hittite language	hit	820	su:"Hittite language"
Luwian language	hit	56	su:"Luwian language"
Hixkaryana language	hix	15	su:"Hixkaryana language"
Hunde language	hke	7	su:"Hunde language"
Halia language	hla	30	su:"Halia language"
Halbi language	hlb	16	su:"Halbi language"
Hua Hmong language	hmd	0	su:"Hua Hmong language"
Hmong language	hmn	1	su:"Hmong language"
Hiri Motu language	hmo	40	su:"Hiri Motu language"
Hmar language	hmr	15	su:"Hmar language"
Kapau language	hmt	0	su:"Kapau language"
Chattisgarhi language	hne	0	su:"Chattisgarhi language"
Hani language	hni	26	su:"Hani language"
Hmong Njua language	hnj	0	su:"Hmong Njua language"
Hanunóo language	hnn	11	su:"Hanunoo language"
Suriname Hindustani language	hns	9	su:"Suriname Hindustani language"
Ho language	hoc	16	su:"Ho language"
Harauti language	hoj	1	su:"Harauti language"
Holu language	hol	2	su:"Holu language"
Holoholo language	hoo	1	su:"Holoholo language"
Hopi language	hop	119	su:"Hopi language"
Hre language	hre	14	su:"Hre language"
Haroi language	hro	5	su:"Haroi language"
Croatian language	hrv	4	su:"Croatian language"
Cakavian language	hrv	0	su:"Cakavian language"
Kajkavian language	hrv	1	su:"Kajkavian language"
Upper Sorbian language	hsb	114	su:"Upper Sorbian language"
Harsusi language	hss	4	su:"Harsusi language"
Huambisa language	hub	17	su:"Huambisa language"
!Xõ language	huc	9	su:"!Xo language"
Huli language	hui	16	su:"Huli language"
Hula language	hul	17	su:"Hula language"
Hungana language	hum	3	su:"Hungana language"
Hungarian language	hun	4	su:"Hungarian language"
Székely language	hun	0	su:"Szekely language"
Hupa language	hup	52	su:"Hupa language"
Chilliwack language	hur	0	su:"Chilliwack language"
Stalo language	hur	15	su:"Stalo language"
Murui language	huu	13	su:"Murui language"
Hunzib language	huz	2	su:"Hunzib language"
Sawu language	hvn	7	su:"Sawu language"
Armenian language	hye	2	su:"Armenian language"
Armenian, Modern language	hye	0	su:"Armenian, Modern language"
East Armenian language	hye	5	su:"East Armenian language"
West Armenian language	hye	1	su:"West Armenian language"
Iai language	iai	30	su:"Iai language"
Iatmul language	ian	15	su:"Iatmul language"
Purari language	iar	18	su:"Purari language"
Iban language	iba	76	su:"Iban language"
Ibibio language	ibb	20	su:"Ibibio language"
Iwaidji language	ibd	0	su:"Iwaidji language"
Ibanag language	ibg	45	su:"Ibanag language"
Ibaloi language	ibl	24	su:"Ibaloi language"
Igbo language	ibo	627	su:"Igbo language"
Ngwa language	ibo	0	su:"Ngwa language"
Ibani language	iby	0	su:"Ibani language"
Icelandic Sign Language language	icl	0	su:"Icelandic Sign Language language"
Idakho-Isukha-Tiriki language	ida	0	su:"Idakho-Isukha-Tiriki language"
Idaca language	idd	2	su:"Idaca language"
Idaté language	idt	1	su:"Idate language"
Idoma language	idu	11	su:"Idoma language"
Amganad Ifugao language	ifa	0	su:"Amganad Ifugao language"
Batad Ifugao language	ifb	0	su:"Batad Ifugao language"
Ayangan Ifugao language	ifb	0	su:"Ayangan Ifugao language"
Tuwali language	ifk	0	su:"Tuwali language"
Kiangan Ifugao language	ifk	0	su:"Kiangan Ifugao language"
Mayoyao Ifugao language	ifu	0	su:"Mayoyao Ifugao language"
Keley-i Kallahan language	ify	1	su:"Keley-i Kallahan language"
Ebira language	igb	15	su:"Ebira language"
Igede language	ige	16	su:"Igede language"
Igala language	igl	21	su:"Igala language"
Mojo language	ign	21	su:"Mojo language"
Interglossa (Artificial) language	igs	4	su:"Interglossa (Artificial) language"
Iha language	ihp	1	su:"Iha language"
Ijo language	ijc	39	su:"Ijo language"
Kolokuma language	ijc	0	su:"Kolokuma language"
Kalabari language	ijn	0	su:"Kalabari language"
Nembe language	ijs	11	su:"Nembe language"
Inuvialuktun language	ikt	0	su:"Inuvialuktun language"
Kopagmiut language	ikt	2	su:"Kopagmiut language"
Inuktitut language	iku	484	su:"Inuktitut language"
Ikwere language	ikw	6	su:"Ikwere language"
Ik language	ikx	5	su:"Ik language"
Ila language	ilb	28	su:"Ila language"
Occidental (Artificial) language	ile	0	su:"Occidental (Artificial) language"
Ilongot language	ilk	13	su:"Ilongot language"
Iloko language	ilo	229	su:"Iloko language"
Imbo Ungu language	imo	3	su:"Imbo Ungu language"
Indonesian language	ind	6	su:"Indonesian language"
Deg Hit'an language	ing	19	su:"Deg Hit'an language"
Ingush language	inh	36	su:"Ingush language"
Ingano language	inj	35	su:"Ingano language"
Indonesian Sign language	inl	6	su:"Indonesian Sign language"
Minaean language	inm	5	su:"Minaean language"
Isinay language	inn	9	su:"Isinay language"
Inoke language	ino	6	su:"Inoke language"
Inapari language	inp	1	su:"Inapari language"
Inor language	ior	0	su:"Inor language"
Irumu language	iou	9	su:"Irumu language"
Iowa language	iow	44	su:"Iowa language"
Oto language	iow	12	su:"Oto language"
Ipili language	ipi	3	su:"Ipili language"
Inupiaq language	ipk	27	su:"Inupiaq language"
Iquito language	iqu	2	su:"Iquito language"
Irahutu language	irh	2	su:"Irahutu language"
Iraqw language	irk	19	su:"Iraqw language"
Iranxe language	irn	2	su:"Iranxe language"
Münkü language	irn	0	su:"Munku language"
Irula language	iru	7	su:"Irula language"
Kasaba language	iru	0	su:"Kasaba language"
Mangyan language	iry	12	su:"Mangyan language"
Isneg language	isd	16	su:"Isneg language"
Italian Sign language	ise	21	su:"Italian Sign language"
Esan language	ish	2	su:"Esan language"
Icelandic language	isl	988	su:"Icelandic language"
Italian language	ita	31	su:"Italian language"
Itene language	ite	1	su:"Itene language"
Judeo-Italian language	itk	24	su:"Judeo-Italian language"
Kamchadal language	itl	39	su:"Kamchadal language"
Itonama language	ito	11	su:"Itonama language"
Itsekiri language	its	9	su:"Itsekiri language"
Itawis language	itv	7	su:"Itawis language"
Itzá language	itz	0	su:"Itza language"
Yao (Southeastern Asia) language	ium	0	su:"Yao (Southeastern Asia) language"
Itbayat language	ivb	0	su:"Itbayat language"
Batan language	ivv	3	su:"Batan language"
Iwam language	iwm	10	su:"Iwam language"
Ixcateco language	ixc	6	su:"Ixcateco language"
Ingrian language	izh	27	su:"Ingrian language"
Ezaa language	izi	6	su:"Ezaa language"
Ikwo language	izi	7	su:"Ikwo language"
Izi language	izi	17	su:"Izi language"
Jarua?ra language	jaa	1	su:"Jarua?ra language"
Yabim language	jae	51	su:"Yabim language"
Jah Hut language	jah	0	su:"Jah Hut language"
Yanyuwa language	jao	26	su:"Yanyuwa language"
Yaqay language	jaq	1	su:"Yaqay language"
Javanese language	jav	1	su:"Javanese language"
Banten language	jav	0	su:"Banten language"
Tegal language	jav	0	su:"Tegal language"
Jebel Nefusa language	jbn	6	su:"Jebel Nefusa language"
Shilha language	jbn	46	su:"Shilha language"
Lojban (Artificial) language	jbo	8	su:"Lojban (Artificial) language"
Jukun language	jbu	20	su:"Jukun language"
Judeo-Tat language	jdt	7	su:"Judeo-Tat language"
Jeh language	jeh	14	su:"Jeh language"
Jeli language	jek	1	su:"Jeli language"
Ngomba (Bamileke) language	jgo	0	su:"Ngomba (Bamileke) language"
Jicaque language	jic	16	su:"Jicaque language"
Djingili language	jig	8	su:"Djingili language"
Jita language	jit	8	su:"Jita language"
Shuar language	jiv	51	su:"Shuar language"
Yamdena language	jmd	8	su:"Yamdena language"
Yemsa language	jnj	1	su:"Yemsa language"
Jaunsari language	jns	0	su:"Jaunsari language"
Japanese language	jpn	45	su:"Japanese language"
Judeo-Persian language	jpr	50	su:"Judeo-Persian language"
Cauqui language	jqr	11	su:"Cauqui language"
Jarai language	jra	41	su:"Jarai language"
Judeo-Arabic language	jrb	313	su:"Judeo-Arabic language"
Jurchen language	juc	52	su:"Jurchen language"
Jirel language	jul	7	su:"Jirel language"
Juang language	jun	2	su:"Juang language"
Jupda language	jup	7	su:"Jupda language"
Yuruna language	jur	1	su:"Yuruna language"
Gyarung language	jya	8	su:"Gyarung language"
Kara-Kalpak language	kaa	104	su:"Kara-Kalpak language"
Kabyle language	kab	115	su:"Kabyle language"
Kachin language	kac	108	su:"Kachin language"
Kara (Central African Republic and Sudan) language	kah	0	su:"Kara (Central African Republic and Sudan) language"
Kaje language	kaj	0	su:"Kaje language"
Kayapa Kallahan language	kak	1	su:"Kayapa Kallahan language"
Kalâtdlisut language	kal	1	su:"Kalatdlisut language"
Ammassalimiut language	kal	0	su:"Ammassalimiut language"
Kamba language	kam	72	su:"Kamba language"
Kannada language	kan	648	su:"Kannada language"
Jenukuruba language	kan	0	su:"Jenukuruba language"
Kassonke language	kao	3	su:"Kassonke language"
Bezhta language	kap	6	su:"Bezhta language"
Capanahua language	kaq	23	su:"Capanahua language"
Kashmiri language	kas	141	su:"Kashmiri language"
Adzhar language	kat	0	su:"Adzhar language"
Georgian language	kat	1	su:"Georgian language"
Gurian language	kat	0	su:"Gurian language"
Imeretian language	kat	0	su:"Imeretian language"
Ingilo language	kat	0	su:"Ingilo language"
Kanuri language	kau	99	su:"Kanuri language"
Kawi language	kaw	214	su:"Kawi language"
Katu language	kax	27	su:"Katu language"
Kamaiurá language	kay	3	su:"Kamaiura language"
Kazakh language	kaz	1	su:"Kazakh language"
Mbaya language	kbc	1	su:"Mbaya language"
Kabardian language	kbd	116	su:"Kabardian language"
Camsa language	kbh	19	su:"Camsa language"
Kare language	kbj	2	su:"Kare language"
Koiari language	kbk	13	su:"Koiari language"
Kanembu language	kbl	5	su:"Kanembu language"
Kaiwa (Papua New Guinea) language	kbm	0	su:"Kaiwa (Papua New Guinea) language"
Karré language	kbn	16	su:"Karre language"
Kabre language	kbp	4	su:"Kabre language"
Kamano language	kbq	32	su:"Kamano language"
Kaffa language	kbr	7	su:"Kaffa language"
Khanty language	kca	127	su:"Khanty language"
Southern Khanty language	kca	0	su:"Southern Khanty language"
Northern Khanty language	kca	1	su:"Northern Khanty language"
Kagoro (Nigeria) language	kcg	0	su:"Kagoro (Nigeria) language"
Katab language	kcg	1	su:"Katab language"
Lilima language	kck	0	su:"Lilima language"
Kalanga (Botswana and Zimbabwe) language	kck	0	su:"Kalanga (Botswana and Zimbabwe) language"
Nubi language	kcn	10	su:"Nubi language"
Kete language	kcv	1	su:"Kete language"
Kattang language	kda	11	su:"Kattang language"
Makonde language	kde	6	su:"Makonde language"
Tem language	kdh	6	su:"Tem language"
Karamojong language	kdj	20	su:"Karamojong language"
Kapone language	kdk	1	su:"Kapone language"
Kagoma language	kdm	1	su:"Kagoma language"
Karaim language	kdr	34	su:"Karaim language"
Kui (Mon-Khmer) language	kdt	0	su:"Kui (Mon-Khmer) language"
Kadu language	kdv	2	su:"Kadu language"
Cape Verde Creole language	kea	0	su:"Cape Verde Creole language"
Kele language	keb	18	su:"Kele language"
Kerebe language	ked	1	su:"Kerebe language"
Kekchi language	kek	243	su:"Kekchi language"
Kela language	kel	2	su:"Kela language"
Kemak language	kem	2	su:"Kemak language"
Anyang language	ken	9	su:"Anyang language"
Kakwa language	keo	0	su:"Kakwa language"
Kera language	ker	13	su:"Kera language"
Ket language	ket	39	su:"Ket language"
Kupia language	key	2	su:"Kupia language"
Kodagu language	kfa	18	su:"Kodagu language"
Konda language	kfc	7	su:"Konda language"
Kota (India) language	kfe	0	su:"Kota (India) language"
Koya language	kff	8	su:"Koya language"
Kurumba language	kfi	8	su:"Kurumba language"
Kanauri language	kfk	17	su:"Kanauri language"
Korwa language	kfp	1	su:"Korwa language"
Kurku language	kfq	15	su:"Kurku language"
Kachchhi language	kfr	0	su:"Kachchhi language"
Bilaspuri language	kfs	0	su:"Bilaspuri language"
Kului language	kfx	5	su:"Kului language"
Kumauni language	kfy	3	su:"Kumauni language"
Komering language	kge	0	su:"Komering language"
Kayu Agung language	kge	3	su:"Kayu Agung language"
Kusunda language	kgg	1	su:"Kusunda language"
Upper Tanudan Kalinga language	kgh	6	su:"Upper Tanudan Kalinga language"
Caingua language	kgk	18	su:"Caingua language"
Krongo language	kgo	3	su:"Krongo language"
Kaingang language	kgp	35	su:"Kaingang language"
Kamoro language	kgq	2	su:"Kamoro language"
Abun language	kgr	14	su:"Abun language"
Kumbainggar language	kgs	7	su:"Kumbainggar language"
Khasi language	kha	96	su:"Khasi language"
Lü language	khb	33	su:"Lu language"
Korowai language	khe	4	su:"Korowai language"
Khalkha language	khk	5	su:"Khalkha language"
Lusi language	khl	4	su:"Lusi language"
Khandesi language	khn	4	su:"Khandesi language"
Khotanese language	kho	62	su:"Khotanese language"
Delki Khadia dialect	khr	1	su:"Delki Khadia dialect"
Kharia language	khr	14	su:"Kharia language"
Khamti language	kht	6	su:"Khamti language"
Khvarshi language	khv	1	su:"Khvarshi language"
Khowar language	khw	21	su:"Khowar language"
Lokele language	khy	12	su:"Lokele language"
Koalib language	kib	1	su:"Koalib language"
Nirere language	kib	0	su:"Nirere language"
Kickapoo language	kic	21	su:"Kickapoo language"
Kiriwinian language	kij	41	su:"Kiriwinian language"
Kikuyu language	kik	177	su:"Kikuyu language"
Tofa language	kim	10	su:"Tofa language"
Kinyarwanda language	kin	300	su:"Kinyarwanda language"
Kiowa language	kio	38	su:"Kiowa language"
Kyrgyz language	kir	543	su:"Kyrgyz language"
Gope language	kiw	1	su:"Gope language"
Northeastern Kiwai language	kiw	0	su:"Northeastern Kiwai language"
Khiamniungan language	kix	1	su:"Khiamniungan language"
Kissi language	kiz	11	su:"Kissi language"
Kanjobal language	kjb	56	su:"Kanjobal language"
Kisar language	kje	6	su:"Kisar language"
Khalaj language	kjf	7	su:"Khalaj language"
Khmu' language	kjg	29	su:"Khmu' language"
Khinalugh language	kjj	3	su:"Khinalugh language"
Acoma language	kjq	1	su:"Acoma language"
Laguna language	kjq	2	su:"Laguna language"
Kashaya language	kju	12	su:"Kashaya language"
Khün language	kkh	15	su:"Khun language"
Kaguru language	kki	5	su:"Kaguru language"
Sagara language	kki	1	su:"Sagara language"
Kako language	kkj	11	su:"Kako language"
Kokota language	kkk	2	su:"Kokota language"
Kosarek language	kkl	3	su:"Kosarek language"
Karko language	kko	1	su:"Karko language"
Kukwa language	kkw	1	su:"Kukwa language"
Seruyan language	kkx	3	su:"Seruyan language"
Guguyimidjir language	kky	0	su:"Guguyimidjir language"
Klamath language	kla	32	su:"Klamath language"
Kiliwa language	klb	9	su:"Kiliwa language"
Kamilaroi language	kld	50	su:"Kamilaroi language"
Kulung language	kle	7	su:"Kulung language"
Sotang Kura language	kle	0	su:"Sotang Kura language"
Tagakaolo language	klg	43	su:"Tagakaolo language"
Kalenjin language	kln	35	su:"Kalenjin language"
Kipsikis language	kln	0	su:"Kipsikis language"
Nandi language	kln	17	su:"Nandi language"
Kairi language	klq	6	su:"Kairi language"
Khaling language	klr	5	su:"Khaling language"
Kalash language	kls	5	su:"Kalash language"
Kru language	klu	31	su:"Kru language"
Kimbundu language	kmb	84	su:"Kimbundu language"
Kâte language	kmg	62	su:"Kate language"
Kalam language	kmh	12	su:"Kalam language"
Lower Tanudan Kalinga language	kml	2	su:"Lower Tanudan Kalinga language"
Kom (India) language	kmm	0	su:"Kom (India) language"
Washkuk language	kmo	24	su:"Washkuk language"
Kamasau language	kms	16	su:"Kamasau language"
Kamtuk language	kmt	9	su:"Kamtuk language"
Kanite language	kmu	23	su:"Kanite language"
Karipuna Creole language	kmv	0	su:"Karipuna Creole language"
Komo (Congo) language	kmw	0	su:"Komo (Congo) language"
Kanakuru language	kna	2	su:"Kanakuru language"
Kankanay language	kne	29	su:"Kankanay language"
Mankanya language	knf	3	su:"Mankanya language"
Koongo (Western Kongo) language	kng	0	su:"Koongo (Western Kongo) language"
Akatek language	knj	14	su:"Akatek language"
Kuranko language	knk	8	su:"Kuranko language"
Agri language	knn	0	su:"Agri language"
Kunabi language	knn	0	su:"Kunabi language"
Semang language	kns	1	su:"Semang language"
Kung-Ekoka language	knw	1	su:"Kung-Ekoka language"
Dayak language	knx	84	su:"Dayak language"
Kagaba language	kog	20	su:"Kagaba language"
Komi-Permyak language	koi	1	su:"Komi-Permyak language"
Konkani language	kok	178	su:"Konkani language"
Komi language	kom	311	su:"Komi language"
Kongo language	kon	247	su:"Kongo language"
Konjo language	koo	4	su:"Konjo language"
Korean language	kor	18	su:"Korean language"
Kusaie language	kos	1	su:"Kusaie language"
Koyukon language	koy	79	su:"Koyukon language"
Curripaco language	kpc	2	su:"Curripaco language"
Kpelle language	kpe	42	su:"Kpelle language"
Komba language	kpf	11	su:"Komba language"
Kapingamarangi language	kpg	13	su:"Kapingamarangi language"
Kreish language	kpl	3	su:"Kreish language"
Srê language	kpm	0	su:"Sre language"
Koho language	kpm	19	su:"Koho language"
Kposo language	kpo	6	su:"Kposo language"
Korape language	kpr	17	su:"Korape language"
Tehit language	kps	5	su:"Tehit language"
Karata language	kpt	3	su:"Karata language"
Komi-Yaz'va language	kpv	0	su:"Komi-Yaz'va language"
Kobon language	kpw	14	su:"Kobon language"
Mountain Koiari language	kpx	9	su:"Mountain Koiari language"
Koryak language	kpy	58	su:"Koryak language"
Palan language	kpy	0	su:"Palan language"
Kalagan language	kqe	25	su:"Kalagan language"
Kaonde language	kqn	58	su:"Kaonde language"
Tchien language	kqo	7	su:"Tchien language"
Korana language	kqz	8	su:"Korana language"
Kumali language	kra	0	su:"Kumali language"
Karachay-Balkar language	krc	123	su:"Karachay-Balkar language"
Krio language	kri	69	su:"Krio language"
Kinaray-a language	krj	8	su:"Kinaray-a language"
Karelian language	krl	113	su:"Karelian language"
Kurukh language	kru	50	su:"Kurukh language"
Kisan language (Dravidian)	kru	1	su:"Kisan language (Dravidian)"
Kurukh language	kru	50	su:"Kurukh language"
Shambala language	ksb	23	su:"Shambala language"
Southern Kalinga language	ksc	14	su:"Southern Kalinga language"
Tolai language	ksd	114	su:"Tolai language"
Bafia language	ksf	20	su:"Bafia language"
Uare language	ksj	0	su:"Uare language"
Kwami language	ksq	1	su:"Kwami language"
Kusu language	ksv	1	su:"Kusu language"
Sgaw Karen language	ksw	34	su:"Sgaw Karen language"
Kedang language	ksx	2	su:"Kedang language"
Kambata language	ktb	3	su:"Kambata language"
Qebena dialect	ktb	0	su:"Qebena dialect"
Gugada language	ktd	1	su:"Gugada language"
Kalkatungu language	ktg	5	su:"Kalkatungu language"
Karanga language	kth	50	su:"Karanga language"
Karitiana language	ktn	5	su:"Karitiana language"
Kituba language	ktu	43	su:"Kituba language"
Kato language	ktw	8	su:"Kato language"
Kuanyama language	kua	91	su:"Kuanyama language"
Kurada language	kud	6	su:"Kurada language"
Kipchak language	kue	92	su:"Kipchak language"
Kuria language	kuj	19	su:"Kuria language"
Kumyk language	kum	30	su:"Kumyk language"
Kunama language	kun	11	su:"Kunama language"
Hazili language	kup	0	su:"Hazili language"
Kunimaipa language	kup	43	su:"Kunimaipa language"
Kurdish language	kur	826	su:"Kurdish language"
Kusaal language	kus	14	su:"Kusaal language"
Kutenai language	kut	1	su:"Kutenai language"
Upper Kuskokwim language	kuu	18	su:"Upper Kuskokwim language"
Kukatja language	kux	79	su:"Kukatja language"
Kuuku Ya'u language	kuy	1	su:"Kuuku Ya'u language"
Atacameno language	kuz	10	su:"Atacameno language"
Bagulal language	kva	3	su:"Bagulal language"
Kubu language	kvb	2	su:"Kubu language"
Komodo language	kvh	1	su:"Komodo language"
Dobel language	kvo	9	su:"Dobel language"
Kerinci language	kvr	16	su:"Kerinci language"
Akit language	kvr	0	su:"Akit language"
Kwaio language	kwd	11	su:"Kwaio language"
Kwerba language	kwe	9	su:"Kwerba language"
Kwara'ae language	kwf	31	su:"Kwara'ae language"
Cuaiquer language	kwi	12	su:"Cuaiquer language"
Kwakiutl language	kwk	109	su:"Kwakiutl language"
Kwangali language	kwn	24	su:"Kwangali language"
Kwese language	kws	2	su:"Kwese language"
Kwakum language	kwu	1	su:"Kwakum language"
Kui language	kxu	45	su:"Kui language"
Kuvi language	kxv	17	su:"Kuvi language"
Ruri language	kya	1	su:"Ruri language"
Kyaka language	kyc	5	su:"Kyaka language"
Karok language	kyh	37	su:"Karok language"
Karao language	kyj	4	su:"Karao language"
Kalapuya language	kyl	6	su:"Kalapuya language"
Kenga language	kyq	5	su:"Kenga language"
Kurmali language	kyw	0	su:"Kurmali language"
Kayabi language	kyz	8	su:"Kayabi language"
Auyana language	kze	4	su:"Auyana language"
Kosena language	kze	7	su:"Kosena language"
Daa language	kzf	6	su:"Daa language"
Dongola-Kenuz language	kzh	0	su:"Dongola-Kenuz language"
Kaike language	kzq	2	su:"Kaike language"
Karang (Cameroon) language	kzr	0	su:"Karang (Cameroon) language"
Kariri language	kzw	13	su:"Kariri language"
Kalabra language	kzz	1	su:"Kalabra language"
Southern Subanen language	laa	0	su:"Southern Subanen language"
Lacandon language	lac	1	su:"Lacandon language"
Hakétia language	lad	16	su:"Haketia language"
Ladino language	lad	392	su:"Ladino language"
Chamba Lahuli language	lae	0	su:"Chamba Lahuli language"
Pattani (India) language	lae	0	su:"Pattani (India) language"
Rangi language	lag	6	su:"Rangi language"
Lahnda language	lah	21	su:"Lahnda language"
Lamba (Zambia and Congo) language	lam	0	su:"Lamba (Zambia and Congo) language"
Lao language	lao	507	su:"Lao language"
Laqua language	laq	2	su:"Laqua language"
Latin language	lat	33	su:"Latin language"
Latvian language	lav	1	su:"Latvian language"
Tiwa language	lax	12	su:"Tiwa language"
Aribwatsa language	laz	3	su:"Aribwatsa language"
Lak language	lbe	38	su:"Lak language"
Lahuli language	lbf	1	su:"Lahuli language"
Ladakhi language	lbj	21	su:"Ladakhi language"
Laven language	lbo	2	su:"Laven language"
Wampar language	lbq	9	su:"Wampar language"
Tolaki language	lbw	11	su:"Tolaki language"
Mekongga language	lbw	1	su:"Mekongga language"
Pasir (Lawangan) language	lbx	0	su:"Pasir (Lawangan) language"
Lawangan language	lbx	2	su:"Lawangan language"
Bawo (Indonesia) language	lbx	0	su:"Bawo (Indonesia) language"
Lamalama language	lby	3	su:"Lamalama language"
Lardil language	lbz	41	su:"Lardil language"
Lucazi language	lch	7	su:"Lucazi language"
Lavongai language	lcm	11	su:"Lavongai language"
Laadi language	ldi	0	su:"Laadi language"
Ambo (Zambia) language	leb	0	su:"Ambo (Zambia) language"
Bisa language	leb	9	su:"Bisa language"
Lendu language	led	9	su:"Lendu language"
Lefana language	lef	10	su:"Lefana language"
Lengua language	leg	4	su:"Lengua language"
Lenje language	leh	15	su:"Lenje language"
Nomaante language	lem	4	su:"Nomaante language"
Lenca language	len	12	su:"Lenca language"
Lepcha language	lep	27	su:"Lepcha language"
Lese language	les	1	su:"Lese language"
Kara (Papua New Guinea) language	leu	0	su:"Kara (Papua New Guinea) language"
Lamma language	lev	1	su:"Lamma language"
Sigi language	lew	4	su:"Sigi language"
Letri lgona language	lex	10	su:"Letri lgona language"
Lezgian language	lez	53	su:"Lezgian language"
Lugbara language	lgg	29	su:"Lugbara language"
Longgu language	lgu	2	su:"Longgu language"
Lhomi language	lhm	2	su:"Lhomi language"
Lahu Bakeo dialect	lhu	1	su:"Lahu Bakeo dialect"
Lahu language	lhu	43	su:"Lahu language"
Ulithi language	li	15	su:"Ulithi language"
Lindrou language	lid	5	su:"Lindrou language"
Limbu language	lif	24	su:"Limbu language"
Ligbi language	lig	1	su:"Ligbi language"
Lika language	lik	2	su:"Lika language"
Lillooet language	lil	14	su:"Lillooet language"
Limburgish language	lim	0	su:"Limburgish language"
Lisu language	lis	49	su:"Lisu language"
Hua Lisu language	lis	0	su:"Hua Lisu language"
Lithuanian language	lit	1	su:"Lithuanian language"
Livonian language	liv	44	su:"Livonian language"
Lembak Bilide language	liw	0	su:"Lembak Bilide language"
Sindang Kelingi language	liw	2	su:"Sindang Kelingi language"
Banda language	liy	12	su:"Banda language"
Linda language	liy	1	su:"Linda language"
Mbinsa language	liz	4	su:"Mbinsa language"
Lampung language	ljp	44	su:"Lampung language"
Ranau language	ljp	2	su:"Ranau language"
Laha (Vietnam) language	lkh	0	su:"Laha (Vietnam) language"
Laki language (Iran)	lki	5	su:"Laki language (Iran)"
Lakona language	lkn	1	su:"Lakona language"
Lakota language	lkt	21	su:"Lakota language"
Ladin language	lld	0	su:"Ladin language"
Lele (Chad) language	lln	0	su:"Lele (Chad) language"
North Efate language	llp	1	su:"North Efate language"
Lolak language	llq	1	su:"Lolak language"
Lau language	llu	30	su:"Lau language"
Limilngan language	lmc	1	su:"Limilngan language"
Lamé (Cameroon) language	lme	0	su:"Lame (Cameroon) language"
Hano language	lml	1	su:"Hano language"
Lambadi language	lmn	2	su:"Lambadi language"
Lombard language	lmo	25	su:"Lombard language"
Limbum language	lmp	10	su:"Limbum language"
Lango language	lno	21	su:"Lango language"
Lamnso' language	lns	2	su:"Lamnso' language"
Guyuk language	lnu	0	su:"Guyuk language"
Longuda language	lnu	6	su:"Longuda language"
Logo language	log	78	su:"Logo language"
Lou language	loj	2	su:"Lou language"
Loko language	lok	7	su:"Loko language"
Mongo-Nkundu language	lol	121	su:"Mongo-Nkundu language"
Ekonda language	lol	0	su:"Ekonda language"
Loma language	lom	54	su:"Loma language"
Lomwe language (Malawi)	lon	2	su:"Lomwe language (Malawi)"
Téén language	lor	0	su:"Teen language"
Lorhon language	lor	1	su:"Lorhon language"
Loniu language	los	2	su:"Loniu language"
Lotuko language	lot	9	su:"Lotuko language"
Lopa (Nepal) language	loy	0	su:"Lopa (Nepal) language"
Lozi language	loz	118	su:"Lozi language"
Larrakia language	lrg	1	su:"Larrakia language"
Leko language	lse	1	su:"Leko language"
Losengo language	lse	3	su:"Losengo language"
Lashi language	lsi	1	su:"Lashi language"
Luxembourgish language	ltz	52	su:"Luxembourgish language"
Luba-Lulua language	lua	61	su:"Luba-Lulua language"
Luba-Katanga language	lub	36	su:"Luba-Katanga language"
Ludic language	lud	0	su:"Ludic language"
Luvale language	lue	59	su:"Luvale language"
Ganda language	lug	293	su:"Ganda language"
Luiseño language	lui	24	su:"Luiseno language"
Lunda language	lun	56	su:"Lunda language"
Luo (Kenya and Tanzania) language	luo	0	su:"Luo (Kenya and Tanzania) language"
Lumbu (Gabon) language	lup	0	su:"Lumbu (Gabon) language"
Lushai language	lus	63	su:"Lushai language"
Nisqually language	lut	7	su:"Nisqually language"
Hanga (Kenya) language	luy	0	su:"Hanga (Kenya) language"
Kisa language	luy	0	su:"Kisa language"
Luyia language	luy	39	su:"Luyia language"
Maku'a (Indonesia) language	lva	0	su:"Maku'a (Indonesia) language"
Lavukaleve language	lvk	3	su:"Lavukaleve language"
Lwo (Sudan) language	lwo	0	su:"Lwo (Sudan) language"
Luyana language	lyn	6	su:"Luyana language"
Laz language	lzz	32	su:"Laz language"
Madurese language	mad	122	su:"Madurese language"
Mafa language	maf	5	su:"Mafa language"
Magahi language	mag	26	su:"Magahi language"
Marshallese language	mah	151	su:"Marshallese language"
Maithili language	mai	74	su:"Maithili language"
Khotta language	mai	0	su:"Khotta language"
Makasar language	mak	120	su:"Makasar language"
Malayalam language	mal	473	su:"Malayalam language"
Moplah language	mal	0	su:"Moplah language"
Mandingo language	man	224	su:"Mandingo language"
Jha?d?i? dialect	mar	2	su:"Jha?d?i? dialect"
Koshti (Marathi) language	mar	0	su:"Koshti (Marathi) language"
Marathi language	mar	830	su:"Marathi language"
Are dialect	mar	1	su:"Are dialect"
Kwafi language	mas	1	su:"Kwafi language"
Masai language	mas	6	su:"Masai language"
Matlatzinca language	mat	26	su:"Matlatzinca language"
Maue language	mav	12	su:"Maue language"
Mampruli language	maw	6	su:"Mampruli language"
Higaonon language	mba	0	su:"Higaonon language"
Western Bukidnon Manobo language	mbb	28	su:"Western Bukidnon Manobo language"
Macusi language	mbc	9	su:"Macusi language"
Dibabawon language	mbd	9	su:"Dibabawon language"
Mangseng language	mbh	9	su:"Mangseng language"
Ilianen Manobo language	mbi	31	su:"Ilianen Manobo language"
Masacali language	mbl	13	su:"Masacali language"
Macaguan language	mbn	1	su:"Macaguan language"
Mbo (Cameroon) language	mbo	0	su:"Mbo (Cameroon) language"
Damana language	mbp	7	su:"Damana language"
Maisin language	mbq	3	su:"Maisin language"
Macú language	mbr	3	su:"Macu language"
Sarangani Manobo language	mbs	19	su:"Sarangani Manobo language"
MatigSalug language	mbt	40	su:"MatigSalug language"
Maring language	mbw	9	su:"Maring language"
Maca language	mca	5	su:"Maca language"
Machiguenga language	mcb	26	su:"Machiguenga language"
Sharanahua language	mcd	15	su:"Sharanahua language"
Mayoruna language	mcf	28	su:"Mayoruna language"
Yecuana language	mch	23	su:"Yecuana language"
Mbunda (Angola and Zambia) language	mck	0	su:"Mbunda (Angola and Zambia) language"
Kristang language	mcm	11	su:"Kristang language"
Masa (Chadic) language	mcn	1	su:"Masa (Chadic) language"
Maka (Cameroon) language	mcp	0	su:"Maka (Cameroon) language"
Managalasi language	mcq	11	su:"Managalasi language"
Mpiemo language	mcx	2	su:"Mpiemo language"
Gbete dialect	mdd	1	su:"Gbete dialect"
Mbum language	mdd	20	su:"Mbum language"
Maba language	mde	12	su:"Maba language"
Moksha language	mdf	0	su:"Moksha language"
Magindanao language	mdh	78	su:"Magindanao language"
Mamvu language	mdi	4	su:"Mamvu language"
Mangbetu language	mdj	11	su:"Mangbetu language"
Mbala (Bandundu, Congo) language	mdp	0	su:"Mbala (Bandundu, Congo) language"
Mandar language	mdr	26	su:"Mandar language"
Mbete language	mdt	3	su:"Mbete language"
Mbosi language	mdw	4	su:"Mbosi language"
Dizi language	mdx	2	su:"Dizi language"
Male (Ethiopia) language	mdy	0	su:"Male (Ethiopia) language"
Mara (Australia) language	mec	0	su:"Mara (Australia) language"
Medlpa language	med	14	su:"Medlpa language"
Midob language	mei	1	su:"Midob language"
Meax language	mej	13	su:"Meax language"
Mekeo language	mek	12	su:"Mekeo language"
Mangala language	mem	24	su:"Mangala language"
Mende language	men	112	su:"Mende language"
Meru language	mer	30	su:"Meru language"
Motu language	meu	144	su:"Motu language"
Mano language	mev	21	su:"Mano language"
Hassaniyya dialect	mey	5	su:"Hassaniyya dialect"
Menominee language	mez	41	su:"Menominee language"
Pattani (Thailand) language	mfa	0	su:"Pattani (Thailand) language"
Lom language	mfb	1	su:"Lom language"
Malgwa language	mfi	0	su:"Malgwa language"
Wandala language	mfi	5	su:"Wandala language"
Moba language	mfq	25	su:"Moba language"
Mexican Sign language	mfs	17	su:"Mexican Sign language"
Mandjak language	mfv	6	su:"Mandjak language"
Mayo (Piman) language	mfy	0	su:"Mayo (Piman) language"
Maban language	mfz	5	su:"Maban language"
Moru language	mgd	16	su:"Moru language"
Migili language	mgi	5	su:"Migili language"
Mambai language	mgm	6	su:"Mambai language"
Meta language (Cameroon)	mgo	2	su:"Meta language (Cameroon)"
Mambwe language	mgr	3	su:"Mambwe language"
Mambwe-Lungu language	mgr	1	su:"Mambwe-Lungu language"
Lungu language	mgr	3	su:"Lungu language"
Mailu language	mgu	14	su:"Mailu language"
Matumbi language	mgw	2	su:"Matumbi language"
Mbugwe language	mgz	1	su:"Mbugwe language"
Mochó language	mhc	4	su:"Mocho language"
Mbugu language	mhd	4	su:"Mbugu language"
Besisi language	mhe	2	su:"Besisi language"
Ma'di (Uganda and Sudan) language	mhi	0	su:"Ma'di (Uganda and Sudan) language"
Moghol language	mhj	5	su:"Moghol language"
Mungaka language	mhk	8	su:"Mungaka language"
Mandan language	mhq	12	su:"Mandan language"
Buru language	mhs	12	su:"Buru language"
Digaro language	mhu	6	su:"Digaro language"
Mbukushu language	mhw	15	su:"Mbukushu language"
Maru language	mhx	7	su:"Maru language"
Maanyan language	mhy	17	su:"Maanyan language"
Illinois language	mia	77	su:"Illinois language"
Miami (Ind. and Okla.) language	mia	0	su:"Miami (Ind. and Okla.) language"
Micmac language	mic	276	su:"Micmac language"
Mandaean language	mid	76	su:"Mandaean language"
Southern Mofu language	mif	21	su:"Southern Mofu language"
Hitchiti language	mik	5	su:"Hitchiti language"
Mikasuki language	mik	10	su:"Mikasuki language"
Minangkabau language	min	117	su:"Minangkabau language"
Jamee language	min	3	su:"Jamee language"
Mukomuko language	min	3	su:"Mukomuko language"
Miskito language	miq	87	su:"Miskito language"
Mongour language	mjg	32	su:"Mongour language"
Mandeali language	mjl	0	su:"Mandeali language"
Malto language	mjt	7	su:"Malto language"
Mikir language	mjw	28	su:"Mikir language"
Mahican language	mjy	8	su:"Mahican language"
Macedonian language	mkd	827	su:"Macedonian language"
Miya language	mkf	2	su:"Miya language"
Mokilese language	mkj	12	su:"Mokilese language"
Moklen language	mkm	1	su:"Moklen language"
East Makian language	mky	2	su:"East Makian language"
Makasai language	mkz	6	su:"Makasai language"
Manambu language	mle	12	su:"Manambu language"
Taimoro language	mlg	0	su:"Taimoro language"
Malagasy language	mlg	825	su:"Malagasy language"
Mulao language	mlm	3	su:"Mulao language"
Mugil language	mlp	5	su:"Mugil language"
Maltese language	mlt	322	su:"Maltese language"
To'abaita language	mlu	18	su:"To'abaita language"
Motlav language	mlv	5	su:"Motlav language"
Malfaxal language	mlx	2	su:"Malfaxal language"
Maonan language	mmd	5	su:"Maonan language"
Mamanwa language	mmn	23	su:"Mamanwa language"
Mandak language	mmx	7	su:"Mandak language"
Jongor language	mmy	1	su:"Jongor language"
Mangap language	mna	11	su:"Mangap language"
Muna language	mnb	18	su:"Muna language"
Mawasangka language	mnb	0	su:"Mawasangka language"
Manchu language	mnc	497	su:"Manchu language"
Mundani language	mnf	7	su:"Mundani language"
Eastern Mnong language	mng	7	su:"Eastern Mnong language"
Mono (Congo) language	mnh	0	su:"Mono (Congo) language"
Manipuri language	mni	61	su:"Manipuri language"
Munji language	mnj	4	su:"Munji language"
Mansi language	mns	87	su:"Mansi language"
Rennellese language	mnv	17	su:"Rennellese language"
Mon language	mnw	104	su:"Mon language"
Muana language	moa	2	su:"Muana language"
Montagnais language	moe	190	su:"Montagnais language"
Mohegan language	mof	35	su:"Mohegan language"
Narragansett language	mof	53	su:"Narragansett language"
Bolaang Mongondow language	mog	19	su:"Bolaang Mongondow language"
Mohawk language	moh	397	su:"Mohawk language"
Monjombo language	moj	1	su:"Monjombo language"
Mongolian language	mon	1	su:"Mongolian language"
Mopan language	mop	5	su:"Mopan language"
Moro (Sudan) language	mor	0	su:"Moro (Sudan) language"
Yana (Burkina Faso and Togo) language	mos	0	su:"Yana (Burkina Faso and Togo) language"
Mooré language	mos	111	su:"Moore language"
Motilon language	mot	0	su:"Motilon language"
Mohave language	mov	16	su:"Mohave language"
Molima language	mox	4	su:"Molima language"
Mocha language	moy	4	su:"Mocha language"
Mokulu language	moz	3	su:"Mokulu language"
Mullukmulluk language	mpb	0	su:"Mullukmulluk language"
Mangarayi language	mpc	17	su:"Mangarayi language"
Majang language	mpe	1	su:"Majang language"
Maung language	mph	209	su:"Maung language"
Mandjildjara language	mpj	0	su:"Mandjildjara language"
Martu Wangka language	mpj	63	su:"Martu Wangka language"
Mbara (Chad) language	mpk	0	su:"Mbara (Chad) language"
Daribi language	mps	20	su:"Daribi language"
Mianmin language	mpt	10	su:"Mianmin language"
Misima language	mpx	14	su:"Misima language"
Misima-Panayati language	mpx	10	su:"Misima-Panayati language"
Panayati language	mpx	18	su:"Panayati language"
Mbuko language	mqb	0	su:"Mbuko language"
Mbelime language	mql	0	su:"Mbelime language"
Moronene language	mqn	4	su:"Moronene language"
West Makian language	mqs	1	su:"West Makian language"
Mouk language	mqt	1	su:"Mouk language"
Manggarai (Indonesia) language	mqy	0	su:"Manggarai (Indonesia) language"
Mlabri language	mra	4	su:"Mlabri language"
Maricopa language	mrc	7	su:"Maricopa language"
Lakher language	mrh	9	su:"Lakher language"
Maori language	mri	4	su:"Maori language"
Mortlockese language	mrl	17	su:"Mortlockese language"
Cheke Holo language	mrn	4	su:"Cheke Holo language"
Nukahiva language	mrq	4	su:"Nukahiva language"
Abujhmaria language	mrr	0	su:"Abujhmaria language"
Madiya-Gondi language	mrr	0	su:"Madiya-Gondi language"
Mangareva language	mrv	23	su:"Mangareva language"
Lanao Moro language	mrw	0	su:"Lanao Moro language"
Maranao language	mrw	78	su:"Maranao language"
Masbateno language	msb	12	su:"Masbateno language"
Musei language	mse	0	su:"Musei language"
Masikoro language	msh	0	su:"Masikoro language"
Mansaka language	msk	26	su:"Mansaka language"
Agusan Manobo language	msm	14	su:"Agusan Manobo language"
Musom language	msu	3	su:"Musom language"
Cotabato Manobo language	mta	42	su:"Cotabato Manobo language"
Mono-Alu language	mte	25	su:"Mono-Alu language"
Una language	mtg	3	su:"Una language"
Mator language	mtm	1	su:"Mator language"
Muong language	mtq	16	su:"Muong language"
Mewari language	mtr	0	su:"Mewari language"
Mota language	mtt	114	su:"Mota language"
Mundang language	mua	6	su:"Mundang language"
Musgu language	mug	9	su:"Musgu language"
Vulum language	mug	0	su:"Vulum language"
Mpus language	mug	0	su:"Mpus language"
Mundu (Sudan and Congo) language	muh	0	su:"Mundu (Sudan and Congo) language"
Penesak language	mui	1	su:"Penesak language"
Musi language	mui	0	su:"Musi language"
Rawas language	mui	2	su:"Rawas language"
Lematang language	mui	1	su:"Lematang language"
Malvi language	mup	0	su:"Malvi language"
Murle language	mur	10	su:"Murle language"
Creek language	mus	183	su:"Creek language"
Seminole language	mus	40	su:"Seminole language"
Muduva language	muv	0	su:"Muduva language"
Miyemu language	mux	2	su:"Miyemu language"
Manam language	mva	7	su:"Manam language"
Mattole language	mvb	5	su:"Mattole language"
Ordos language	mvf	0	su:"Ordos language"
Chahar language	mvf	1	su:"Chahar language"
Minaveha language	mvn	10	su:"Minaveha language"
Marovo language	mvo	9	su:"Marovo language"
Maiya language	mvy	4	su:"Maiya language"
Mesqan language	mvz	0	su:"Mesqan language"
Mukawa language	mwc	16	su:"Mukawa language"
Mudburra language	mwd	25	su:"Mudburra language"
Murrinhpatha language	mwf	272	su:"Murrinhpatha language"
Labo language	mwi	4	su:"Labo language"
Mirandese language	mwl	0	su:"Mirandese language"
Majingai language	mwm	0	su:"Majingai language"
Mabuiag language	mwp	0	su:"Mabuiag language"
Mün Chin language	mwq	6	su:"Mun Chin language"
Dingal language	mwr	5	su:"Dingal language"
Marwari language	mwr	7	su:"Marwari language"
Moken language	mwt	6	su:"Moken language"
Mentawai language	mwv	24	su:"Mentawai language"
White Hmong language	mww	1	su:"White Hmong language"
Manyika language	mxc	1	su:"Manyika language"
Mele-Fila language	mxe	12	su:"Mele-Fila language"
Miju language	mxj	0	su:"Miju language"
Monumbo language	mxk	2	su:"Monumbo language"
Maxi language	mxl	0	su:"Maxi language"
Mada (Cameroon) language	mxu	0	su:"Mada (Cameroon) language"
Mau language	mxx	0	su:"Mau language"
Munduruku language	my	14	su:"Munduruku language"
Burmese language	mya	1	su:"Burmese language"
Mbai (Moissala) language	myb	0	su:"Mbai (Moissala) language"
Mpongwe language	mye	40	su:"Mpongwe language"
Mamara language	myk	26	su:"Mamara language"
Mura language	myp	0	su:"Mura language"
Pirahá language	myp	1	su:"Piraha language"
Munichi language	myr	2	su:"Munichi language"
Muyuw language	myw	27	su:"Muyuw language"
Gisu language	myx	6	su:"Gisu language"
Macuna language	myy	17	su:"Macuna language"
Mzab language	mzb	5	su:"Mzab language"
Mumuye language	mzm	7	su:"Mumuye language"
Movima language	mzp	9	su:"Movima language"
Mori language	mzq	21	su:"Mori language"
Mo (Côte d'Ivoire and Ghana) language	mzw	0	su:"Mo (Cote d'Ivoire and Ghana) language"
Narak language	nac	32	su:"Narak language"
Nabak language	naf	18	su:"Nabak language"
Nahuatl language	nah	1	su:"Nahuatl language"
Nakanai language	nak	15	su:"Nakanai language"
Nalik language	nal	2	su:"Nalik language"
Ngankikurungkurr language	nam	1	su:"Ngankikurungkurr language"
Nama language	naq	78	su:"Nama language"
Kongara language	nas	0	su:"Kongara language"
Nauru language	nau	30	su:"Nauru language"
Navajo language	nav	785	su:"Navajo language"
Narrinyeri language	nay	22	su:"Narrinyeri language"
Ganguela language	nba	18	su:"Ganguela language"
Chang language	nbc	8	su:"Chang language"
Konyak language	nbe	8	su:"Konyak language"
Naxi language	nbf	80	su:"Naxi language"
Mao Naga language	nbi	6	su:"Mao Naga language"
Ngarinyman language	nbj	17	su:"Ngarinyman language"
Ndebele (South Africa) language	nbl	2	su:"Ndebele (South Africa) language"
Ngbaka ma'bo language	nbm	12	su:"Ngbaka ma'bo language"
Rongmei language	nbu	0	su:"Rongmei language"
Wangkumara (Galali) language	nbx	0	su:"Wangkumara (Galali) language"
Nahu language	nca	2	su:"Nahu language"
Nancowry language	ncb	5	su:"Nancowry language"
Notsi language	ncf	1	su:"Notsi language"
Niska language	ncg	18	su:"Niska language"
Nakara language	nck	3	su:"Nakara language"
Sibo language	nco	29	su:"Sibo language"
Nicaraguan Sign language	ncs	7	su:"Nicaraguan Sign language"
Chothe Naga language	nct	1	su:"Chothe Naga language"
Nchumburu language	ncu	3	su:"Nchumburu language"
Natchez language	ncz	4	su:"Natchez language"
Taensa language	ncz	15	su:"Taensa language"
Ndau language	ndc	24	su:"Ndau language"
Ndebele (Zimbabwe) language	nde	0	su:"Ndebele (Zimbabwe) language"
Ndali language	ndh	1	su:"Ndali language"
Samba Leko language	ndi	1	su:"Samba Leko language"
Ndonga language	ndo	107	su:"Ndonga language"
Ndunga language	ndt	1	su:"Ndunga language"
Tura language	neb	10	su:"Tura language"
Kumak language	nee	8	su:"Kumak language"
Negidal language	neg	2	su:"Negidal language"
Nemi language	nem	5	su:"Nemi language"
Nengone language	nen	44	su:"Nengone language"
Baitadi dialect	nep	1	su:"Baitadi dialect"
Nepali language	nep	474	su:"Nepali language"
Nyaheun language	nev	1	su:"Nyaheun language"
Newari language	new	123	su:"Newari language"
Pahri language	new	0	su:"Pahri language"
Dolakha language	new	0	su:"Dolakha language"
Nez Percé language	nez	119	su:"Nez Perce language"
Ayiwo language	nfl	4	su:"Ayiwo language"
Nafaanra language	nfr	4	su:"Nafaanra language"
Ngombe language	ngc	15	su:"Ngombe language"
Doko (Congo) language	ngc	0	su:"Doko (Congo) language"
Ngemba (Cameroon) language	nge	0	su:"Ngemba (Cameroon) language"
Mankon language	nge	0	su:"Mankon language"
Khomani language	ngh	0	su:"Khomani language"
Ngizim language	ngi	8	su:"Ngizim language"
Lomwe language (Mozambique)	ngl	1	su:"Lomwe language (Mozambique)"
Ngatik language	ngm	1	su:"Ngatik language"
Ngoni language (Tanzania and Mozambique)	ngo	2	su:"Ngoni language (Tanzania and Mozambique)"
Beng language	nhb	2	su:"Beng language"
Chiripá language	nhd	0	su:"Chiripa language"
Takuu language	nho	1	su:"Takuu language"
Nharo language	nhr	3	su:"Nharo language"
Noone language	nhu	8	su:"Noone language"
Nias language	nia	45	su:"Nias language"
Ngandi language	nid	12	su:"Ngandi language"
Nielim language	nie	5	su:"Nielim language"
Ngalakan language	nig	20	su:"Ngalakan language"
Nyiha language	nih	3	su:"Nyiha language"
Nii language	nii	22	su:"Nii language"
Ngaju language	nij	31	su:"Ngaju language"
Katingan language	nij	2	su:"Katingan language"
Kahayan language	nij	1	su:"Kahayan language"
Nilamba language	nim	4	su:"Nilamba language"
Nganasan language	nio	11	su:"Nganasan language"
Nimboran language	nir	3	su:"Nimboran language"
Niuean language	niu	281	su:"Niuean language"
Gilyak language	niv	51	su:"Gilyak language"
Ngiti language	niy	1	su:"Ngiti language"
Nocte language	njb	3	su:"Nocte language"
Lhota language	njh	18	su:"Lhota language"
Tenyidie dialect	njm	2	su:"Tenyidie dialect"
Angami language	njm	31	su:"Angami language"
Liangmai Naga language	njn	5	su:"Liangmai Naga language"
Ao language	njo	40	su:"Ao language"
Ngadju (Australia) language	nju	0	su:"Ngadju (Australia) language"
Nkoya language	nka	5	su:"Nkoya language"
Khezha language	nkh	4	su:"Khezha language"
Nogugu language	nkk	8	su:"Nogugu language"
Nkunya language	nko	0	su:"Nkunya language"
Nukuoro language	nkr	20	su:"Nukuoro language"
Dutch language	nld	8	su:"Dutch language"
Florida language	nlg	80	su:"Florida language"
Nihali language	nll	1	su:"Nihali language"
Maram language	nma	2	su:"Maram language"
Big Nambas language	nmb	2	su:"Big Nambas language"
Ngama language	nmc	0	su:"Ngama language"
Ndumu language	nmd	5	su:"Ndumu language"
Tangkhul language	nmf	21	su:"Tangkhul language"
Ukhrul language	nmf	0	su:"Ukhrul language"
Bisio language	nmg	4	su:"Bisio language"
Moshang language	nmh	1	su:"Moshang language"
Namakura language	nmk	2	su:"Namakura language"
Nambya language	nmq	11	su:"Nambya language"
Nawdm language	nmz	4	su:"Nawdm language"
Nyangumarta language	nna	73	su:"Nyangumarta language"
Nande language	nnb	14	su:"Nande language"
Nancere language	nnc	2	su:"Nancere language"
Ngyemboon language	nnh	15	su:"Ngyemboon language"
Nankina language	nnk	3	su:"Nankina language"
Namia language	nnm	5	su:"Namia language"
Norwegian (Nynorsk) language	nno	0	su:"Norwegian (Nynorsk) language"
Wancho language	nnp	2	su:"Wancho language"
Nanticoke language	nnt	6	su:"Nanticoke language"
Nukunu language	nnv	1	su:"Nukunu language"
Waunana language	noa	9	su:"Waunana language"
Northern Thai language	nod	140	su:"Northern Thai language"
Nimadi language	noe	0	su:"Nimadi language"
Nogai language	nog	29	su:"Nogai language"
Old Norse language	non	958	su:"Old Norse language"
Nootka language	noo	98	su:"Nootka language"
Norwegian language	nor	3	su:"Norwegian language"
Nomatsiguenga language	not	25	su:"Nomatsiguenga language"
Notu language	nou	4	su:"Notu language"
Novial (Artificial) language	nov	10	su:"Novial (Artificial) language"
Nyambo language	now	4	su:"Nyambo language"
Phom language	nph	2	su:"Phom language"
Pochury language	npo	1	su:"Pochury language"
Napu language	npy	16	su:"Napu language"
Baria language	nrb	0	su:"Baria language"
Rengma language	nre	10	su:"Rengma language"
Chakhesang language	nri	0	su:"Chakhesang language"
Ngarluma language	nrl	49	su:"Ngarluma language"
Norn language	nrn	0	su:"Norn language"
Lala language	nrz	11	su:"Lala language"
Sangtam language	nsa	3	su:"Sangtam language"
Senga language	nse	1	su:"Senga language"
Naskapi language	nsk	22	su:"Naskapi language"
Sema language	nsm	18	su:"Sema language"
Nehan language	nsn	2	su:"Nehan language"
Gananwa language	nso	0	su:"Gananwa language"
Lobedu language	nso	0	su:"Lobedu language"
Northern Sotho language	nso	586	su:"Northern Sotho language"
Northern Sierra Miwok language	nsq	2	su:"Northern Sierra Miwok language"
Nali language	nss	2	su:"Nali language"
Moklum language	nst	0	su:"Moklum language"
Tangsa language	nst	4	su:"Tangsa language"
Lungchang language	nst	0	su:"Lungchang language"
Yogli language	nst	0	su:"Yogli language"
Nisenan language	nsz	9	su:"Nisenan language"
Ngaanyatjara language	ntj	0	su:"Ngaanyatjara language"
Nateni language	ntm	2	su:"Nateni language"
Ntomba language	nto	11	su:"Ntomba language"
Natanzi language	ntz	1	su:"Natanzi language"
Kombe language	nui	6	su:"Kombe language"
Nung language	nun	43	su:"Nung language"
Nguôn language	nuo	0	su:"Nguon language"
Nupe language	nup	40	su:"Nupe language"
Nuer language	nus	32	su:"Nuer language"
Tay-Nung language	nut	17	su:"Tay-Nung language"
Nunggubuyu language	nuy	107	su:"Nunggubuyu language"
Nyabwa language	nwb	13	su:"Nyabwa language"
Bangwa language	nwe	2	su:"Bangwa language"
Ngada language	nxg	8	su:"Ngada language"
Ngawun language	nxn	13	su:"Ngawun language"
Chewa language	nya	0	su:"Chewa language"
Nyanja language	nya	266	su:"Nyanja language"
Nyore language	nyd	12	su:"Nyore language"
Giryama language	nyf	27	su:"Giryama language"
Nyikina language	nyh	31	su:"Nyikina language"
Nyanga language	nyj	7	su:"Nyanga language"
Nyaneka language	nyk	6	su:"Nyaneka language"
Nyamwezi language	nym	10	su:"Nyamwezi language"
Nyankole language	nyn	37	su:"Nyankole language"
Nyoro language	nyo	23	su:"Nyoro language"
Nyungwe language	nyu	17	su:"Nyungwe language"
Nyulnyul language	nyv	3	su:"Nyulnyul language"
Ngonde language	nyy	11	su:"Ngonde language"
Nzebi language	nzb	2	su:"Nzebi language"
Nzima language	nzi	40	su:"Nzima language"
Nzakara language	nzk	1	su:"Nzakara language"
Zeme language	nzm	7	su:"Zeme language"
New Zealand Sign language	nzs	93	su:"New Zealand Sign language"
Orok language	oaa	14	su:"Orok language"
Oroch language	oac	6	su:"Oroch language"
Bagobo language	obo	10	su:"Bagobo language"
Manuvu language	obo	6	su:"Manuvu language"
Obo Manobo language	obo	11	su:"Obo Manobo language"
Ocaina language	oca	14	su:"Ocaina language"
Béarnais language	oci	0	su:"Bearnais language"
Gascon language	oci	5	su:"Gascon language"
Occitan language	oci	920	su:"Occitan language"
Ocuiltec language	ocu	5	su:"Ocuiltec language"
Odual language	odu	4	su:"Odual language"
Ofo language	ofo	5	su:"Ofo language"
Kana language	ogo	12	su:"Kana language"
Ogbronuagum language	ogu	3	su:"Ogbronuagum language"
Nipissing language	ojc	40	su:"Nipissing language"
Ojibwa language	oji	1	su:"Ojibwa language"
Japanese--Heian period, 794-1185 language	ojp	0	su:"Japanese--Heian period, 794-1185 language"
Leuangiua language	ojv	6	su:"Leuangiua language"
Colville language	oka	1	su:"Colville language"
Okanagan language	oka	15	su:"Okanagan language"
Korean--Middle Korean, 935-1500 language	okm	0	su:"Korean--Middle Korean, 935-1500 language"
Korean--To 935 language	oko	0	su:"Korean--To 935 language"
Okrika language	okr	0	su:"Okrika language"
Orokaiva language	okv	17	su:"Orokaiva language"
Olonets language	olo	0	su:"Olonets language"
Omaha language	oma	21	su:"Omaha language"
Yunca language	omc	30	su:"Yunca language"
Omi language	omi	1	su:"Omi language"
Ombo language	oml	2	su:"Ombo language"
Ona language	ona	22	su:"Ona language"
Be language	onb	5	su:"Be language"
Oneida language	one	73	su:"Oneida language"
Olo language	ong	12	su:"Olo language"
Onondaga language	ono	46	su:"Onondaga language"
Ono language	ons	2	su:"Ono language"
Tohono O'Odham language	ood	0	su:"Tohono O'Odham language"
Pima language	ood	54	su:"Pima language"
Önge language	oon	6	su:"Onge language"
Oksapmin language	opm	11	su:"Oksapmin language"
Eudeve language	opt	16	su:"Eudeve language"
Opata language	opt	17	su:"Opata language"
Orma language	orc	1	su:"Orma language"
Orejón language	ore	11	su:"Orejon language"
Oroqen language	orh	10	su:"Oroqen language"
Oriya language	ori	275	su:"Oriya language"
Sambalpuri language	ori	1	su:"Sambalpuri language"
Oromo language	orm	168	su:"Oromo language"
Orokolo language	oro	10	su:"Orokolo language"
Adiwasi Oriya language	ort	5	su:"Adiwasi Oriya language"
Ormuri language	oru	8	su:"Ormuri language"
Ormu language	orz	1	su:"Ormu language"
Osage language	osa	35	su:"Osage language"
Oscan language	osc	27	su:"Oscan language"
Osing language	osi	1	su:"Osing language"
Ossetic language	oss	169	su:"Ossetic language"
Old Saxon language	osx	231	su:"Old Saxon language"
Ot Danum language	otd	2	su:"Ot Danum language"
Old Turkic language	otk	161	su:"Old Turkic language"
Ottawa language	otw	67	su:"Ottawa language"
Ouargla language	oua	7	su:"Ouargla language"
Wayampi language	oym	14	su:"Wayampi language"
Koozime language	ozm	0	su:"Koozime language"
Oghuz language	ozn	12	su:"Oghuz language"
Paressi language	pab	14	su:"Paressi language"
Pacoh language	pac	22	su:"Pacoh language"
Purupuru language	pad	7	su:"Purupuru language"
Pangasinan language	pag	59	su:"Pangasinan language"
Parintintin language	pah	0	su:"Parintintin language"
Tenharim language	pah	10	su:"Tenharim language"
Pahlavi language	pal	423	su:"Pahlavi language"
Pampanga language	pam	128	su:"Pampanga language"
Panjabi language	pan	2	su:"Panjabi language"
Northern Paiute language	pao	43	su:"Northern Paiute language"
Parya language	paq	4	su:"Parya language"
Panamint language	par	9	su:"Panamint language"
Palauan language	pau	110	su:"Palauan language"
Pakaasnovos language	pav	2	su:"Pakaasnovos language"
Pawnee language	paw	25	su:"Pawnee language"
Paez language	pbb	41	su:"Paez language"
Panzaleo language	pbb	1	su:"Panzaleo language"
Patamona language	pbc	4	su:"Patamona language"
Paraujano language	pbg	1	su:"Paraujano language"
Panare language	pbh	9	su:"Panare language"
Paduko language	pbi	8	su:"Paduko language"
Badyara language	pbp	2	su:"Badyara language"
Pangwa language	pbr	5	su:"Pangwa language"
Kaili language	pbz	20	su:"Kaili language"
Pear language	pcb	1	su:"Pear language"
Bouyei language	pcc	18	su:"Bouyei language"
Yay language	pcc	1	su:"Yay language"
Parji language	pci	4	su:"Parji language"
Parengi language	pcj	4	su:"Parengi language"
Paite language	pck	12	su:"Paite language"
Pennsylvania German language	pdc	10	su:"Pennsylvania German language"
Kayan language	pdu	18	su:"Kayan language"
Peranakan Indonesian language	pea	2	su:"Peranakan Indonesian language"
Eastern Pomo language	peb	3	su:"Eastern Pomo language"
Pay language	ped	6	su:"Pay language"
Pengo language	peg	1	su:"Pengo language"
Bonan language	peh	7	su:"Bonan language"
Northern Pomo language	pej	1	su:"Northern Pomo language"
Pekal language	pel	2	su:"Pekal language"
Pende language	pem	11	su:"Pende language"
Old Persian language	peo	181	su:"Old Persian language"
Petats language	pex	8	su:"Petats language"
Phalura language	phl	3	su:"Phalura language"
Phoenician language	phn	144	su:"Phoenician language"
Pothwari language	phr	0	su:"Pothwari language"
Phu Thai language	pht	3	su:"Phu Thai language"
Pima Bajo language	pia	9	su:"Pima Bajo language"
Piaroa language	pid	12	su:"Piaroa language"
Piro (Tanoan) language	pie	3	su:"Piro (Tanoan) language"
Pingelap language	pif	10	su:"Pingelap language"
Pitcairnese language	pih	7	su:"Pitcairnese language"
Quioucohanock language	pim	2	su:"Quioucohanock language"
Powhatan language	pim	6	su:"Powhatan language"
Piapoco language	pio	15	su:"Piapoco language"
Pero language	pip	4	su:"Pero language"
Piratapuyo language	pir	3	su:"Piratapuyo language"
Pitta Pitta language	pit	2	su:"Pitta Pitta language"
Pintupi language	piu	330	su:"Pintupi language"
Pileni language	piv	7	su:"Pileni language"
Pitjantjatjara language	pjt	460	su:"Pitjantjatjara language"
Suk language	pko	18	su:"Suk language"
Paku language	pku	3	su:"Paku language"
Pilaga language	plg	11	su:"Pilaga language"
Pali language	pli	919	su:"Pali language"
Oluta language	plo	1	su:"Oluta language"
Palaic language	plq	8	su:"Palaic language"
Betsileo language	plt	0	su:"Betsileo language"
Palicur language	plu	10	su:"Palicur language"
Paama language	pma	19	su:"Paama language"
Bareë language	pmf	2	su:"Baree language"
Pamona language	pmf	10	su:"Pamona language"
Tuamotuan language	pmt	28	su:"Tuamotuan language"
Plains Miwok language	pmw	1	su:"Plains Miwok language"
Pinai-Hagahai language	pnn	7	su:"Pinai-Hagahai language"
Panobo language	pno	10	su:"Panobo language"
Ponosakan language	pns	3	su:"Ponosakan language"
Banyjima language	pnw	6	su:"Banyjima language"
Pinyin language	pny	27	su:"Pinyin language"
Sierra Popoluca language	poi	28	su:"Sierra Popoluca language"
Polish language	pol	10	su:"Polish language"
Southeastern Pomo language	pom	2	su:"Southeastern Pomo language"
Ponape language	pon	3	su:"Ponape language"
Central Pomo language	poo	1	su:"Central Pomo language"
Portuguese language	por	12	su:"Portuguese language"
Sayula language	pos	7	su:"Sayula language"
Potawatomi language	pot	72	su:"Potawatomi language"
Crioulo language	pov	32	su:"Crioulo language"
Polabian language	pox	44	su:"Polabian language"
Pogoro language	poy	1	su:"Pogoro language"
Paipai language	ppi	6	su:"Paipai language"
Uma language	ppk	12	su:"Uma language"
Pipil language	ppl	33	su:"Pipil language"
Folopa language	ppo	14	su:"Folopa language"
Pelende language	ppp	0	su:"Pelende language"
Asu language	ppt	6	su:"Asu language"
Passamaquoddy language	pqm	101	su:"Passamaquoddy language"
Prussian language	prg	98	su:"Prussian language"
Paici language	pri	14	su:"Paici language"
Provençal language	pro	1	su:"Provencal language"
Dari language	prs	187	su:"Dari language"
Madaglashti language	prs	0	su:"Madaglashti language"
Purik language	prx	3	su:"Purik language"
Ogan language	pse	4	su:"Ogan language"
Semendo language	pse	0	su:"Semendo language"
Serawai language	pse	8	su:"Serawai language"
Besemah language	pse	0	su:"Besemah language"
Enim language	pse	0	su:"Enim language"
Lintang language	pse	0	su:"Lintang language"
Bengkulu language	pse	2	su:"Bengkulu language"
Pauserna language	psm	2	su:"Pauserna language"
Portuguese Sign language	psr	4	su:"Portuguese Sign language"
Kaulong language	pss	4	su:"Kaulong language"
Sauraseni language	psu	5	su:"Sauraseni language"
Port Sandwich language	psw	4	su:"Port Sandwich language"
Patep language	ptp	15	su:"Patep language"
Puelche language	pue	15	su:"Puelche language"
Puoc language	puo	1	su:"Puoc language"
Puquina language	puq	11	su:"Puquina language"
Pushto language	pus	455	su:"Pushto language"
Punu language	puu	13	su:"Punu language"
Puluwat language	puw	4	su:"Puluwat language"
Pawaian language	pwa	2	su:"Pawaian language"
Gapapaiwa language	pwg	3	su:"Gapapaiwa language"
Melebuganon language	pwm	8	su:"Melebuganon language"
Paiwan language	pwn	18	su:"Paiwan language"
Powari language	pwr	0	su:"Powari language"
Fyam language	pym	1	su:"Fyam language"
Quechua language	que	1	su:"Quechua language"
Cañari language	quf	1	su:"Canari language"
Quileute language	qui	9	su:"Quileute language"
Sipacapense language	qum	10	su:"Sipacapense language"
Quinault language	qun	4	su:"Quinault language"
Sacapulteco language	quv	18	su:"Sacapulteco language"
Huanca language	qvw	1	su:"Huanca language"
Quenya (Artificial) language	qya	6	su:"Quenya (Artificial) language"
Quinnipiac language	qyp	12	su:"Quinnipiac language"
Chamling language	rab	8	su:"Chamling language"
Rade language	rad	54	su:"Rade language"
Western Meohang language	raf	0	su:"Western Meohang language"
Logooli language	rag	37	su:"Logooli language"
Rabha language	rah	9	su:"Rabha language"
Rangdania language	rah	0	su:"Rangdania language"
Ramoaaina language	rai	0	su:"Ramoaaina language"
Rajasthani language	raj	75	su:"Rajasthani language"
Canella language	ram	9	su:"Canella language"
Rao language	rao	8	su:"Rao language"
Rapanui language	rap	141	su:"Rapanui language"
Sami language	raq	329	su:"Sami language"
Mangaian language	rar	11	su:"Mangaian language"
Rarotongan language	rar	469	su:"Rarotongan language"
Sampang language	rav	1	su:"Sampang language"
Rawang language	raw	10	su:"Rawang language"
Rembong language	reb	2	su:"Rembong language"
Rejang (Sumatra, Indonesia) language	rej	0	su:"Rejang (Sumatra, Indonesia) language"
Rendille language	rel	8	su:"Rendille language"
Rengao language	ren	18	su:"Rengao language"
Rang Pas language	rgk	2	su:"Rang Pas language"
Resigero language	rgr	4	su:"Resigero language"
Roti language	rgu	12	su:"Roti language"
Rif language	rif	28	su:"Rif language"
Riang-lang language	ril	1	su:"Riang-lang language"
Ritarungo language	rit	0	su:"Ritarungo language"
Rajbangsi language	rjs	3	su:"Rajbangsi language"
Rikbaktsa language	rkb	6	su:"Rikbaktsa language"
Arakanese language	rki	6	su:"Arakanese language"
Rama language	rma	9	su:"Rama language"
Rembarrnga language	rmb	45	su:"Rembarrnga language"
Roma language	rmm	3	su:"Roma language"
Caló (Romani) language	rmr	0	su:"Calo (Romani) language"
Lovari language	rmy	0	su:"Lovari language"
Ruund language	rnd	14	su:"Ruund language"
Ronga language	rng	37	su:"Ronga language"
Northern Roglai language	rog	1	su:"Northern Roglai language"
Raeto-Romance language	roh	723	su:"Raeto-Romance language"
Romani language	rom	382	su:"Romani language"
Romanian language	ron/rum	2	su:"Romanian language"
Rotokas language	roo	21	su:"Rotokas language"
Kriol language	rop	452	su:"Kriol language"
Runga language	rou	1	su:"Runga language"
Roro (New Guinea) language	rro	0	su:"Roro (New Guinea) language"
Ratahan language	rth	2	su:"Ratahan language"
Rotuman language	rtm	49	su:"Rotuman language"
Carpatho-Rusyn language	rue	55	su:"Carpatho-Rusyn language"
Roviana language	rug	51	su:"Roviana language"
Moldavian language	rum	2	su:"Moldavian language"
Rundi language	run	118	su:"Rundi language"
Istro-Romanian language	ruo	0	su:"Istro-Romanian language"
Aromanian language	rup	1	su:"Aromanian language"
Russian language	rus	47	su:"Russian language"
Rutul language	rut	8	su:"Rutul language"
Rawa language	rwo	9	su:"Rawa language"
Bikaneri language	rwr	1	su:"Bikaneri language"
Fox language	sac	42	su:"Fox language"
Sandawe language	sad	9	su:"Sandawe language"
Sango (Ubangi Creole) language	sag	0	su:"Sango (Ubangi Creole) language"
Yakut language	sah	291	su:"Yakut language"
Sahu language	saj	1	su:"Sahu language"
Samaritan Aramaic language	sam	121	su:"Samaritan Aramaic language"
Sanskrit language	san	5	su:"Sanskrit language"
Samburu language	saq	4	su:"Samburu language"
Sasak language	sas	62	su:"Sasak language"
Santali language	sat	98	su:"Santali language"
Sawi language	saw	1	su:"Sawi language"
Saurashtri language	saz	0	su:"Saurashtri language"
Gambai language	sba	3	su:"Gambai language"
Mandegusu language	sbb	1	su:"Mandegusu language"
Saliva language	sbe	17	su:"Saliva language"
Safwa language	sbk	4	su:"Safwa language"
Botolan Sambal language	sbl	0	su:"Botolan Sambal language"
Sangu (Tanzania) language	sbp	0	su:"Sangu (Tanzania) language"
Subiya language	sbs	2	su:"Subiya language"
Ruc language	scb	2	su:"Ruc language"
Dongxiang language	sce	8	su:"Dongxiang language"
Sadani language	sck	1	su:"Sadani language"
Shina language	scl	16	su:"Shina language"
Scots language	sco	748	su:"Scots language"
Toraja language	sda	31	su:"Toraja language"
Toraja Sa'dan language	sda	16	su:"Toraja Sa'dan language"
Bukar Sadong language	sdo	2	su:"Bukar Sadong language"
Sherdukpen language	sdp	1	su:"Sherdukpen language"
Semai language	sea	4	su:"Semai language"
Sechelt language	sec	4	su:"Sechelt language"
Sedang language	sed	29	su:"Sedang language"
Seneca language	see	128	su:"Seneca language"
Senari language	sef	26	su:"Senari language"
Tyembara language	sef	0	su:"Tyembara language"
Sena language	seh	19	su:"Sena language"
Seri language	sei	36	su:"Seri language"
Sekani language	sek	4	su:"Sekani language"
Selkup language	sel	58	su:"Selkup language"
Koyraboro Senni language	ses	0	su:"Koyraboro Senni language"
Sentani language	set	19	su:"Sentani language"
Secoya language	sey	7	su:"Secoya language"
South African Sign language	sfs	14	su:"South African Sign language"
Ayta Anchi Sambal language	sgb	0	su:"Ayta Anchi Sambal language"
Bartang language	sgh	0	su:"Bartang language"
Khuf language	sgh	0	su:"Khuf language"
Shughni language	sgh	2	su:"Shughni language"
Ishkashmi language	sgl	0	su:"Ishkashmi language"
Zebaki language	sgl	0	su:"Zebaki language"
Chaha language	sgw	3	su:"Chaha language"
Sursurunga language	sgz	6	su:"Sursurunga language"
Shoshoni language	shh	67	su:"Shoshoni language"
Shilluk language	shk	21	su:"Shilluk language"
Shan language	shn	101	su:"Shan language"
Shipibo-Conibo language	shp	20	su:"Shipibo-Conibo language"
Shi language	shr	46	su:"Shi language"
Shuswap language	shs	50	su:"Shuswap language"
Shasta language	sht	10	su:"Shasta language"
Shauri language	shv	3	su:"Shauri language"
Syènara language	shz	1	su:"Syenara language"
Sidamo language	sid	17	su:"Sidamo language"
Mwenyi language	sie	1	su:"Mwenyi language"
Pasaale language	sig	2	su:"Pasaale language"
Mende (Papua New Guinea) language	sim	0	su:"Mende (Papua New Guinea) language"
Sinhalese language	sin	658	su:"Sinhalese language"
Dänjong-kä language	sip	8	su:"Danjong-ka language"
Siuslaw language	sis	1	su:"Siuslaw language"
Siwai language	siw	17	su:"Siwai language"
Sivandi language	siy	1	su:"Sivandi language"
Siwa language	siz	5	su:"Siwa language"
Epena Saija language	sja	18	su:"Epena Saija language"
Kildin Sami language	sjd	0	su:"Kildin Sami language"
Miji language	sjl	1	su:"Miji language"
Jama Mapun language	sjm	12	su:"Jama Mapun language"
Sindarin (Artificial) language	sjn	4	su:"Sindarin (Artificial) language"
Siar-Lak language	sjr	2	su:"Siar-Lak language"
Shawnee language	sjw	59	su:"Shawnee language"
Saek language	skb	2	su:"Saek language"
Sakalava language	skg	0	su:"Sakalava language"
Sikka language	ski	5	su:"Sikka language"
Siraiki Hindki language	skr	0	su:"Siraiki Hindki language"
Siraiki Sindhi language	skr	0	su:"Siraiki Sindhi language"
Siraiki language	skr	35	su:"Siraiki language"
Sakata language	skt	15	su:"Sakata language"
Sakau language	sku	14	su:"Sakau language"
Skou language	skv	3	su:"Skou language"
Sissala language	sld	26	su:"Sissala language"
Soliga language	sle	0	su:"Soliga language"
Slovak language	slk	1	su:"Slovak language"
Yui language	sll	34	su:"Yui language"
Pangutaran Sama language	slm	12	su:"Pangutaran Sama language"
Salinan language	sln	16	su:"Salinan language"
Lamaholot language	slp	10	su:"Lamaholot language"
Lewoingu dialect	slp	2	su:"Lewoingu dialect"
Salar language	slr	15	su:"Salar language"
Slovenian language	slv	1	su:"Slovenian language"
Salampasu language	slx	3	su:"Salampasu language"
Ma'ya (Indonesia) language	slz	0	su:"Ma'ya (Indonesia) language"
Southern Sami language	sma	0	su:"Southern Sami language"
Northern Sami language	sme	0	su:"Northern Sami language"
Lule Sami language	smj	0	su:"Lule Sami language"
Bolinao language	smk	0	su:"Bolinao language"
Central Sama language	sml	4	su:"Central Sama language"
Inari Sami language	smn	1	su:"Inari Sami language"
Samoan language	smo	1	su:"Samoan language"
Samaritan Hebrew language	smp	12	su:"Samaritan Hebrew language"
Samo language	smq	23	su:"Samo language"
Simeulue language	smr	10	su:"Simeulue language"
Skolt Sami language	sms	0	su:"Skolt Sami language"
Simte language	smt	3	su:"Simte language"
Sumbawa language	smw	11	su:"Sumbawa language"
Zezuru language	sna	0	su:"Zezuru language"
Shona language	sna	763	su:"Shona language"
Korekore language	sna	0	su:"Korekore language"
Sinagoro language	snc	10	su:"Sinagoro language"
Sindhi language	snd	243	su:"Sindhi language"
Bau-Jagoi language	sne	0	su:"Bau-Jagoi language"
Noon language	snf	2	su:"Noon language"
Sanga language	sng	8	su:"Sanga language"
Soninke language	snk	103	su:"Soninke language"
Sangil language	snl	20	su:"Sangil language"
Sioni language	snn	4	su:"Sioni language"
Snohomish language	sno	4	su:"Snohomish language"
Lambau language	snp	0	su:"Lambau language"
Siane language	snp	23	su:"Siane language"
Komunku language	snp	0	su:"Komunku language"
Sangu (Gabon) language	snq	0	su:"Sangu (Gabon) language"
Sobei language	sob	1	su:"Sobei language"
Sogdian language	sog	80	su:"Sogdian language"
Somali language	som	905	su:"Somali language"
Songye language	sop	9	su:"Songye language"
Sembla language	sos	1	su:"Sembla language"
Sotho language	sot	1	su:"Sotho language"
Southern Thai language	sou	17	su:"Southern Thai language"
Spanish language	spa	106	su:"Spanish language"
Selepet language	spl	25	su:"Selepet language"
Spokane language	spo	24	su:"Spokane language"
Suppire language	spp	2	su:"Suppire language"
Saposa language	sps	3	su:"Saposa language"
Sapuan language	spu	1	su:"Sapuan language"
Sabaot language	spy	13	su:"Sabaot language"
Albanian language	sqi	1	su:"Albanian language"
Susquehanna language	sqn	1	su:"Susquehanna language"
Sokotri language	sqt	4	su:"Sokotri language"
Squawmish language	squ	6	su:"Squawmish language"
Suquamish language	squ	3	su:"Suquamish language"
Sora language	srb	20	su:"Sora language"
Sardinian language	srd	284	su:"Sardinian language"
Sara language	sre	9	su:"Sara language"
Sulod language	srg	0	su:"Sulod language"
Sarikoli language	srh	0	su:"Sarikoli language"
Siriano language	sri	34	su:"Siriano language"
Saberi language	srl	16	su:"Saberi language"
Saramaccan language	srm	57	su:"Saramaccan language"
Sranan language	srn	75	su:"Sranan language"
Serbian language	srp	588	su:"Serbian language"
Stokavian language	srp	0	su:"Stokavian language"
Serer language	srr	67	su:"Serer language"
Sarsi language	srs	15	su:"Sarsi language"
Sirmauri language	srx	0	su:"Sirmauri language"
Sama Sibutu language	ssb	12	su:"Sama Sibutu language"
Siroi language	ssd	7	su:"Siroi language"
Balangingì language	sse	0	su:"Balangingi language"
Thao language	ssf	9	su:"Thao language"
Sissano language	sso	4	su:"Sissano language"
Spanish Sign language	ssp	49	su:"Spanish Sign language"
Swazi language	ssw	177	su:"Swazi language"
Saho language	ssy	10	su:"Saho language"
Lummi language	str	3	su:"Lummi language"
Saanich language	str	2	su:"Saanich language"
North Straits Salish language	str	4	su:"North Straits Salish language"
Silte language	stv	1	su:"Silte language"
Sulka language	sua	16	su:"Sulka language"
Suku (Congo) language	sub	0	su:"Suku (Congo) language"
Western Subanon language	suc	0	su:"Western Subanon language"
Suena language	sue	11	su:"Suena language"
Suba language	suh	5	su:"Suba language"
Sukuma language	suk	21	su:"Sukuma language"
Tawahka (Honduras) language	sum	0	su:"Tawahka (Honduras) language"
Sumo language	sum	22	su:"Sumo language"
Ulva language	sum	0	su:"Ulva language"
Sundanese language	sun	498	su:"Sundanese language"
Cirebon language	sun	0	su:"Cirebon language"
Mupun language	sur	0	su:"Mupun language"
Mwaghavul language	sur	4	su:"Mwaghavul language"
Susu language	sus	64	su:"Susu language"
Sulung language	suv	2	su:"Sulung language"
Sumerian language	sux	1	su:"Sumerian language"
Sunwar language	suz	8	su:"Sunwar language"
Svan language	sva	33	su:"Svan language"
Lashkh language	sva	0	su:"Lashkh language"
Shimaore language	swb	0	su:"Shimaore language"
Kingwana language	swc	17	su:"Kingwana language"
Swedish language	swe	6	su:"Swedish language"
Mwini dialect	swh	1	su:"Mwini dialect"
Cifundi language	swh	0	su:"Cifundi language"
Swahili language	swh	3	su:"Swahili language"
Sui language	swi	16	su:"Sui language"
Sira language	swj	6	su:"Sira language"
Swedish Sign language	swl	14	su:"Swedish Sign language"
Suau language	swp	22	su:"Suau language"
Saweru language	swr	1	su:"Saweru language"
Suwawa language	swu	10	su:"Suwawa language"
Bune Bonda language	swu	0	su:"Bune Bonda language"
Shekhawati language	swv	0	su:"Shekhawati language"
Sangir (Indonesia and Philippines) language	sxn	0	su:"Sangir (Indonesia and Philippines) language"
Central Subanen language	syb	0	su:"Central Subanen language"
Sylheti language	syl	0	su:"Sylheti language"
Syriac language	syr	1	su:"Syriac language"
Kagate language	syw	0	su:"Kagate language"
Semelai language	sza	4	su:"Semelai language"
Sawai language	szw	6	su:"Sawai language"
Tabasaran language	tab	22	su:"Tabasaran language"
Tariana language	tae	6	su:"Tariana language"
Tapirapé language	taf	4	su:"Tapirape language"
Tagoi language	tag	1	su:"Tagoi language"
Tahitian language	tah	383	su:"Tahitian language"
Tamil language	tam	6	su:"Tamil language"
Tangale language	tan	12	su:"Tangale language"
Yami language	tao	4	su:"Yami language"
Tabwa language	tap	1	su:"Tabwa language"
Kitabwa language	tap	5	su:"Kitabwa language"
Mishar language	tat	2	su:"Mishar language"
Tatar language	tat	871	su:"Tatar language"
Upper Tanana language	tau	7	su:"Upper Tanana language"
Pamoa language	tav	16	su:"Pamoa language"
Atayal language	tay	31	su:"Atayal language"
Kaki Ae language	tbd	3	su:"Kaki Ae language"
Dharawal language	tbh	5	su:"Dharawal language"
Ingassana language	tbi	3	su:"Ingassana language"
Kalamian language	tbk	12	su:"Kalamian language"
Tboli language	tbl	74	su:"Tboli language"
Tavara (Papua New Guinea) language	tbo	0	su:"Tavara (Papua New Guinea) language"
Tembo (Sud-Kivu, Congo) language	tbt	0	su:"Tembo (Sud-Kivu, Congo) language"
Tagbanua language	tbw	37	su:"Tagbanua language"
Somba language	tbz	11	su:"Somba language"
Tucuna language	tca	37	su:"Tucuna language"
Tanacross language	tcb	10	su:"Tanacross language"
Southern Tutchone language	tce	2	su:"Southern Tutchone language"
Toda (India) language	tcx	0	su:"Toda (India) language"
Tulu language	tcy	39	su:"Tulu language"
Kuki language	tcz	15	su:"Kuki language"
Thado language	tcz	8	su:"Thado language"
Tai Nüa language	tdd	9	su:"Tai Nua language"
Thulung language	tdh	2	su:"Thulung language"
Tondano language	tdn	13	su:"Tondano language"
Temiar language	tea	4	su:"Temiar language"
Tepo language	ted	6	su:"Tepo language"
Teke language	teg	25	su:"Teke language"
Tzoneca language	teh	47	su:"Tzoneca language"
Konda?Reddi dialect	tel	0	su:"Konda?Reddi dialect"
Telugu language	tel	1	su:"Telugu language"
Temne language	tem	69	su:"Temne language"
Teso language	teo	31	su:"Teso language"
Terena language	ter	15	su:"Terena language"
Tengger language	tes	0	su:"Tengger language"
Tetum language	tet	100	su:"Tetum language"
So (Uganda) language	teu	0	su:"So (Uganda) language"
Tewa language	tew	36	su:"Tewa language"
Dena'ina language	tfn	44	su:"Dena'ina language"
Terraba language	tfr	13	su:"Terraba language"
Ternate language	tft	9	su:"Ternate language"
Tigak language	tgc	9	su:"Tigak language"
Tanga (Tanga Islands) language	tgg	0	su:"Tanga (Tanga Islands) language"
Tajik language	tgk	418	su:"Tajik language"
Tagalog language	tgl	2	su:"Tagalog language"
Tagula language	tgo	1	su:"Tagula language"
Tagbana language	tgw	1	su:"Tagbana language"
Tagish language	tgx	2	su:"Tagish language"
Thai language	tha	4	su:"Thai language"
Thayore language	thd	3	su:"Thayore language"
Tharaka language	thk	12	su:"Tharaka language"
Ntlakyapamuk language	thp	36	su:"Ntlakyapamuk language"
Thakali language	ths	7	su:"Thakali language"
Tifal language	tif	8	su:"Tifal language"
Tigré language	tig	61	su:"Tigre language"
Tikar language	tik	16	su:"Tikar language"
Tillamook language	til	7	su:"Tillamook language"
Timbe language	tim	6	su:"Timbe language"
Tindi language	tin	1	su:"Tindi language"
Teop language	tio	6	su:"Teop language"
Tiéfo language	tiq	1	su:"Tiefo language"
Tigrinya language	tir	198	su:"Tigrinya language"
Tiv language	tiv	61	su:"Tiv language"
Tiwi (Australia) language	tiw	0	su:"Tiwi (Australia) language"
Isleta language	tix	6	su:"Isleta language"
Tiruray language	tiy	28	su:"Tiruray language"
Timucua language	tjm	31	su:"Timucua language"
Tokelauan language	tkl	230	su:"Tokelauan language"
Takelma language	tkm	12	su:"Takelma language"
Tikopia language	tkp	7	su:"Tikopia language"
Tsakhur language	tkr	6	su:"Tsakhur language"
Tobelo language	tlb	16	su:"Tobelo language"
Talaud language	tld	9	su:"Talaud language"
Nenusa-Miangas language	tld	0	su:"Nenusa-Miangas language"
Telefol language	tlf	12	su:"Telefol language"
Klingon (Artificial) language	tlh	30	su:"Klingon (Artificial) language"
Tlingit language	tli	213	su:"Tlingit language"
Talinga-Bwisi language	tlj	2	su:"Talinga-Bwisi language"
Tetela language	tll	39	su:"Tetela language"
Talise language	tlr	1	su:"Talise language"
Sobojo language	tlv	2	su:"Sobojo language"
Talysh language	tly	16	su:"Talysh language"
Avava language	tmb	1	su:"Avava language"
Tumak language	tmc	1	su:"Tumak language"
Tamajaq language	tmh	1	su:"Tamajaq language"
Taman language (Indonesia)	tmn	1	su:"Taman language (Indonesia)"
Tumleo language	tmq	2	su:"Tumleo language"
Tami language	tmy	0	su:"Tami language"
Tacana (Bolivia) language	tna	0	su:"Tacana (Bolivia) language"
Lenakel language	tnl	12	su:"Lenakel language"
Tabla language	tnm	5	su:"Tabla language"
Tepera language	tnm	4	su:"Tepera language"
Taino language	tnq	35	su:"Taino language"
Bedik language	tnr	7	su:"Bedik language"
Tontemboan language	tnt	27	su:"Tontemboan language"
Toba (Indian) language	tob	0	su:"Toba (Indian) language"
Toma language	tod	3	su:"Toma language"
Tonga (Nyasa) language	tog	0	su:"Tonga (Nyasa) language"
Tonga (Inhambane) language	toh	0	su:"Tonga (Inhambane) language"
Tojolabal language	toj	57	su:"Tojolabal language"
Tombulu language	tom	12	su:"Tombulu language"
Tongan language	ton	615	su:"Tongan language"
Toposa language	toq	3	su:"Toposa language"
Tho language	tou	17	su:"Tho language"
Jemez language	tow	5	su:"Jemez language"
Tok Pisin language	tpi	229	su:"Tok Pisin language"
Tampulma language	tpm	5	su:"Tampulma language"
Tupi language	tpw	329	su:"Tupi language"
Trumai language	tpy	2	su:"Trumai language"
Tinputz language	tpz	3	su:"Tinputz language"
Tenetehara language	tqb	25	su:"Tenetehara language"
Toaripi language	tqo	28	su:"Toaripi language"
Tunni language	tqq	1	su:"Tunni language"
Tonkawa language	tqw	11	su:"Tonkawa language"
Trio language	tri	10	su:"Trio language"
Kok Borok language	trp	25	su:"Kok Borok language"
Sedik language	trv	8	su:"Sedik language"
Torwali language	trw	4	su:"Torwali language"
Tsamai language	tsb	2	su:"Tsamai language"
Tswa language	tsc	28	su:"Tswa language"
Tsakonian language	tsd	0	su:"Tsakonian language"
Sulu language	tsg	21	su:"Sulu language"
Tausug language	tsg	47	su:"Tausug language"
Tsimshian language	tsi	92	su:"Tsimshian language"
Memba language	tsj	2	su:"Memba language"
Tswana language	tsn	783	su:"Tswana language"
Tsonga language	tso	357	su:"Tsonga language"
Thai Sign Language language	tsq	0	su:"Thai Sign Language language"
Akei language	tsr	3	su:"Akei language"
Tsou language	tsu	15	su:"Tsou language"
Tsogo language	tsv	3	su:"Tsogo language"
Tarascan language	tsz	198	su:"Tarascan language"
Tutelo language	tta	6	su:"Tutelo language"
Tectiteco language	ttc	21	su:"Tectiteco language"
Tubetube language	tte	17	su:"Tubetube language"
Tooro language	ttj	25	su:"Tooro language"
Tera language	ttr	4	su:"Tera language"
Tat language	ttt	41	su:"Tat language"
Tubatulabal language	tub	14	su:"Tubatulabal language"
Tuyuca language	tue	13	su:"Tuyuca language"
Tupuri language	tui	7	su:"Tupuri language"
Turkmen language	tuk	322	su:"Turkmen language"
Tumbuka language	tum	62	su:"Tumbuka language"
Tunica language	tun	10	su:"Tunica language"
Tucano language	tuo	37	su:"Tucano language"
Teda language	tuq	1	su:"Teda language"
Turkish language	tur	6	su:"Turkish language"
Tuscarora language	tus	18	su:"Tuscarora language"
Turkana language	tuv	12	su:"Turkana language"
Tugen language	tuy	0	su:"Tugen language"
Tuvaluan language	tvl	66	su:"Tuvaluan language"
Tidore language	tvo	9	su:"Tidore language"
Taveta language	tvs	5	su:"Taveta language"
Tutsa language	tvt	1	su:"Tutsa language"
White Tai language	twh	21	su:"White Tai language"
Twi language	twi	355	su:"Twi language"
Tawoyan language	twy	2	su:"Tawoyan language"
Tombonuwo language	txa	5	su:"Tombonuwo language"
Tolitoli language	txe	5	su:"Tolitoli language"
Tangut language	txg	106	su:"Tangut language"
Thracian language	txh	38	su:"Thracian language"
Tonsea language	txs	4	su:"Tonsea language"
Cayapo language	txu	15	su:"Cayapo language"
Tatana' language	txx	3	su:"Tatana' language"
Tauya language	tya	1	su:"Tauya language"
Kombai language	tyn	1	su:"Kombai language"
Tuvinian language	tyv	83	su:"Tuvinian language"
Ubir language	ubr	8	su:"Ubir language"
Gawigl language	ubu	19	su:"Gawigl language"
Ubykh language	uby	13	su:"Ubykh language"
Udekhe language	ude	10	su:"Udekhe language"
Udi language	udi	12	su:"Udi language"
Uldeme language	udl	8	su:"Uldeme language"
Udmurt language	udm	257	su:"Udmurt language"
Uduk language	udu	6	su:"Uduk language"
Ugaritic language	uga	372	su:"Ugaritic language"
Uighur language	uig	526	su:"Uighur language"
Ukrainian language	ukr	5	su:"Ukrainian language"
Olcha language	ulc	6	su:"Olcha language"
Umbundu language	umb	63	su:"Umbundu language"
Umotina language	umo	2	su:"Umotina language"
Umpila language	ump	30	su:"Umpila language"
Munsee language	umu	26	su:"Munsee language"
Ngarinyin language	ung	16	su:"Ngarinyin language"
Worora language	unp	15	su:"Worora language"
Bhumij language	unr	4	su:"Bhumij language"
Unde Kaili language	unz	0	su:"Unde Kaili language"
Atchin language	upv	4	su:"Atchin language"
Uripiv language	upv	8	su:"Uripiv language"
Urarina language	ura	13	su:"Urarina language"
Urubu language	urb	9	su:"Urubu language"
Urubu Kaapor language	urb	2	su:"Urubu Kaapor language"
Urdu language	urd	2	su:"Urdu language"
Uru language	ure	5	su:"Uru language"
Urhobo language	urh	18	su:"Urhobo language"
Urim language	uri	3	su:"Urim language"
Urak Lawoi' language	urk	7	su:"Urak Lawoi' language"
Urali language	url	1	su:"Urali language"
Orya language	ury	14	su:"Orya language"
Usarufa language	usa	14	su:"Usarufa language"
Uspanteca language	usp	37	su:"Uspanteca language"
Chemehuevi language	ute	3	su:"Chemehuevi language"
Southern Paiute language	ute	36	su:"Southern Paiute language"
Ute language	ute	41	su:"Ute language"
Greek Tatar language	uum	3	su:"Greek Tatar language"
Pazeh language	uun	6	su:"Pazeh language"
Ura (Vanuatu) language	uur	0	su:"Ura (Vanuatu) language"
Urii language	uvh	10	su:"Urii language"
Lote language	uvl	6	su:"Lote language"
Uzbek language	uzb	877	su:"Uzbek language"
Sart language	uzn	0	su:"Sart language"
Vaagri Boli language	vaa	2	su:"Vaagri Boli language"
Vagala language	vag	10	su:"Vagala language"
Varhadi-Nagpuri language	vah	0	su:"Varhadi-Nagpuri language"
Vai language	vai	48	su:"Vai language"
Valman language	van	2	su:"Valman language"
Vaiphei language	vap	5	su:"Vaiphei language"
Guarijío language	var	8	su:"Guarijio language"
Dehawali language	vas	0	su:"Dehawali language"
Hayu language	vay	0	su:"Hayu language"
Vayu language	vay	0	su:"Vayu language"
Veddah (Sinhalese) language	ved	0	su:"Veddah (Sinhalese) language"
Venda language	ven	299	su:"Venda language"
Veps language	vep	56	su:"Veps language"
Vietnamese language	vie	8	su:"Vietnamese language"
Vili language	vif	4	su:"Vili language"
Vige language	vig	1	su:"Vige language"
Vilela language	vil	3	su:"Vilela language"
Lule language	vil	5	su:"Lule language"
Iduna language	viv	50	su:"Iduna language"
Martuyhunira language	vma	1	su:"Martuyhunira language"
Votic language	vot	25	su:"Votic language"
Venezuelan Sign language	vsl	3	su:"Venezuelan Sign language"
Vute language	vut	9	su:"Vute language"
Tlakluit language	wac	5	su:"Tlakluit language"
Wasco language	wac	3	su:"Wasco language"
Wandamen language	wad	7	su:"Wandamen language"
Walser language	wae	5	su:"Walser language"
Waffa language	waj	16	su:"Waffa language"
Walamo language	wal	0	su:"Walamo language"
Massachuset language	wam	113	su:"Massachuset language"
Wampanoag language	wam	6	su:"Wampanoag language"
Wappo language	wao	4	su:"Wappo language"
Wageman language	waq	8	su:"Wageman language"
Washo language	was	0	su:"Washo language"
Waiwai language	waw	9	su:"Waiwai language"
Wayana language	way	22	su:"Wayana language"
Warao language	wba	37	su:"Warao language"
Mwamba language	wbh	1	su:"Mwamba language"
Waigali language	wbk	1	su:"Waigali language"
Wakhi language	wbl	24	su:"Wakhi language"
Wa language	wbm	32	su:"Wa language"
Warlpiri language	wbp	979	su:"Warlpiri language"
Wagdi language	wbr	0	su:"Wagdi language"
Watjari language	wbv	5	su:"Watjari language"
Wedau language	wed	39	su:"Wedau language"
Wewewa language	wew	0	su:"Wewewa language"
Wangganguru language	wgg	33	su:"Wangganguru language"
Wahgi language	wgi	5	su:"Wahgi language"
Wichita language	wic	7	su:"Wichita language"
Wik-Mungkan language	wim	167	su:"Wik-Mungkan language"
Winnebago language	win	53	su:"Winnebago language"
Wintu language	wit	14	su:"Wintu language"
Wiru language	wiu	28	su:"Wiru language"
Wirangu language	wiw	10	su:"Wirangu language"
Wiyot language	wiy	23	su:"Wiyot language"
Waja language	wja	3	su:"Waja language"
Wakawaka language	wkw	0	su:"Wakawaka language"
Duungidjawu language	wkw	2	su:"Duungidjawu language"
Walloon language	wln	11	su:"Walloon language"
Wolio language	wlo	13	su:"Wolio language"
East Uvean language	wls	18	su:"East Uvean language"
Vejoz language	wlv	4	su:"Vejoz language"
Wambule language	wme	2	su:"Wambule language"
Waima'a language	wmh	3	su:"Waima'a language"
Wambon language	wms	2	su:"Wambon language"
Walmatjari language	wmt	0	su:"Walmatjari language"
Wantoat language	wnc	9	su:"Wantoat language"
Wandarang language	wnd	1	su:"Wandarang language"
Wanetsi language	wne	0	su:"Wanetsi language"
Usan language	wnu	3	su:"Usan language"
Wobe language	wob	15	su:"Wobe language"
Woleai language	woe	0	su:"Woleai language"
Woisika language	woi	4	su:"Woisika language"
Wolof language	wol	463	su:"Wolof language"
Lebou language	wol	0	su:"Lebou language"
Manui language	wow	1	su:"Manui language"
Warapu language	wra	2	su:"Warapu language"
Wiradjuri language	wrh	46	su:"Wiradjuri language"
Wariyangga language	wri	1	su:"Wariyangga language"
Warumungu language	wrm	44	su:"Warumungu language"
Waropen language	wrp	10	su:"Waropen language"
Wardaman language	wrr	14	su:"Wardaman language"
Waris language	wrs	5	su:"Waris language"
Waray language	wrz	49	su:"Waray language"
Warembori language	wsa	1	su:"Warembori language"
Waskia language	wsk	7	su:"Waskia language"
Wotapuri-Katarqalai language	wsv	1	su:"Wotapuri-Katarqalai language"
Berta language	wti	4	su:"Berta language"
Mewati language	wtm	0	su:"Mewati language"
Wotu language	wtw	3	su:"Wotu language"
Wutun language	wuh	2	su:"Wutun language"
Wuvulu language	wuv	2	su:"Wuvulu language"
Waama language	wwa	3	su:"Waama language"
Warrwa language	wwr	0	su:"Warrwa language"
Wyandot language	wya	116	su:"Wyandot language"
Wongaibon language	wyb	16	su:"Wongaibon language"
Kalmyk language	xal	172	su:"Kalmyk language"
Oirat language	xal	40	su:"Oirat language"
Torgut language	xal	0	su:"Torgut language"
Kham language	xam	16	su:"Kham language"
Apalachee language	xap	10	su:"Apalachee language"
Kamassin language	xas	6	su:"Kamassin language"
Xavante language	xav	33	su:"Xavante language"
Kawaiisu language	xaw	5	su:"Kawaiisu language"
Kambera language	xbr	1	su:"Kambera language"
Celtiberian language	xce	14	su:"Celtiberian language"
Armenian, Classical language	xcl	0	su:"Armenian, Classical language"
Carian language	xcr	12	su:"Carian language"
Coahuilteco language	xcw	12	su:"Coahuilteco language"
Dacian language	xdc	10	su:"Dacian language"
Lamandau language	xdy	1	su:"Lamandau language"
Eblaite language	xeb	92	su:"Eblaite language"
Hedi language	xed	3	su:"Hedi language"
Faliscan language	xfa	10	su:"Faliscan language"
Khetrani language	xhe	0	su:"Khetrani language"
Xhosa language	xho	914	su:"Xhosa language"
Hattic language	xht	8	su:"Hattic language"
Hurrian language	xhu	80	su:"Hurrian language"
Iberian language	xib	90	su:"Iberian language"
Xinca language	xin	18	su:"Xinca language"
Mendalam Kayan language	xkd	0	su:"Mendalam Kayan language"
Kgalagadi language	xkv	5	su:"Kgalagadi language"
Ngologa language	xkv	0	su:"Ngologa language"
Kamula language	xla	11	su:"Kamula language"
Lycian language	xlc	38	su:"Lycian language"
Lydian language	xld	26	su:"Lydian language"
Median language	xme	3	su:"Median language"
Mingrelian language	xmf	30	su:"Mingrelian language"
Meroitic language	xmr	51	su:"Meroitic language"
Tsimihety language	xmw	0	su:"Tsimihety language"
Northern Kankanay language	xnn	1	su:"Northern Kankanay language"
Anglo-Norman language	xno	4	su:"Anglo-Norman language"
Kangri language	xnr	0	su:"Kangri language"
Soga language	xog	7	su:"Soga language"
Konkomba language	xon	10	su:"Konkomba language"
Phrygian language	xpg	13	su:"Phrygian language"
Parthian language	xpr	23	su:"Parthian language"
Punic language	xpu	41	su:"Punic language"
Kraho language	xra	3	su:"Kraho language"
Raetian language	xrr	5	su:"Raetian language"
Sabaean language	xsa	20	su:"Sabaean language"
Tina Sambal language	xsb	0	su:"Tina Sambal language"
Sio language	xsi	4	su:"Sio language"
Kasem language	xsm	41	su:"Kasem language"
Nunuma language	xsm	0	su:"Nunuma language"
Sherpa language	xsr	19	su:"Sherpa language"
Saisiyat language	xsy	6	su:"Saisiyat language"
Ketengban language	xte	13	su:"Ketengban language"
Alu-Kurumba language	xua	2	su:"Alu-Kurumba language"
Umbrian language	xum	27	su:"Umbrian language"
Kuo language	xuo	4	su:"Kuo language"
Urartian language	xur	44	su:"Urartian language"
Khoikhoi language	xuu	29	su:"Khoikhoi language"
Venetic language	xve	26	su:"Venetic language"
Vandal language	xvn	5	su:"Vandal language"
Woccon language	xwc	1	su:"Woccon language"
Zhangzhung language	xzh	9	su:"Zhangzhung language"
Jaminaua language	yaa	9	su:"Jaminaua language"
Yagua language	yad	18	su:"Yagua language"
Yaruro language	yae	10	su:"Yaruro language"
Yaka (Congo and Angola) language	yaf	0	su:"Yaka (Congo and Angola) language"
Yahgan language	yag	27	su:"Yahgan language"
Yazghulami language	yah	16	su:"Yazghulami language"
Yaghnobi language	yai	6	su:"Yaghnobi language"
Yakama language	yak	16	su:"Yakama language"
Yalunka language	yal	4	su:"Yalunka language"
Yamba (Cameroon and Nigeria) language	yam	0	su:"Yamba (Cameroon and Nigeria) language"
Yao (Africa) language	yao	0	su:"Yao (Africa) language"
Yapese language	yap	71	su:"Yapese language"
Yaqui language	yaq	49	su:"Yaqui language"
Gunu language	yas	17	su:"Gunu language"
Yambeta language	yat	8	su:"Yambeta language"
Yakö language	yaz	6	su:"Yako language"
Yala language	yba	5	su:"Yala language"
Yemba language	ybb	9	su:"Yemba language"
Yellow Uighur language	ybe	4	su:"Yellow Uighur language"
Western Yugur language	ybe	3	su:"Western Yugur language"
Yakha language	ybh	1	su:"Yakha language"
Yamphu language	ybi	2	su:"Yamphu language"
Yabiyufa language	yby	6	su:"Yabiyufa language"
Yucuna language	ycn	16	su:"Yucuna language"
Yerava language	yea	0	su:"Yerava language"
Yeniche language	yec	3	su:"Yeniche language"
Yimas language	yee	1	su:"Yimas language"
Tarok language	yer	4	su:"Tarok language"
Yerukala language	yeu	0	su:"Yerukala language"
Yeyi language	yey	5	su:"Yeyi language"
Hua (Papua New Guinea) language	ygr	0	su:"Hua (Papua New Guinea) language"
Yagaria language	ygr	13	su:"Yagaria language"
Yinggarda language	yia	14	su:"Yinggarda language"
Yiddish language	yid	3	su:"Yiddish language"
Yidiny language	yii	2	su:"Yidiny language"
Jindjibandji language	yij	0	su:"Jindjibandji language"
Yimchungru language	yim	2	su:"Yimchungru language"
Yir-Yoront language	yiy	38	su:"Yir-Yoront language"
Yakan language	yka	33	su:"Yakan language"
Yasa language	yko	0	su:"Yasa language"
Yakoma language	yky	4	su:"Yakoma language"
Yele language	yle	8	su:"Yele language"
Nyalayu language	yly	2	su:"Nyalayu language"
Iamalele language	yml	14	su:"Iamalele language"
Maay language	ymm	1	su:"Maay language"
Mysian language	yms	1	su:"Mysian language"
Yana language	ynn	18	su:"Yana language"
Yahi language	ynn	1	su:"Yahi language"
Yanzi language	yns	12	su:"Yanzi language"
Tanimuca-Retuama language	ynu	5	su:"Tanimuca-Retuama language"
Yogad language	yog	4	su:"Yogad language"
Yokuts language	yok	20	su:"Yokuts language"
Yombe (Congo and Angola) language	yom	0	su:"Yombe (Congo and Angola) language"
Yongkom language	yon	12	su:"Yongkom language"
Ijebu language	yor	0	su:"Ijebu language"
Yoruba language	yor	1	su:"Yoruba language"
Yareba language	yrb	19	su:"Yareba language"
Yaouré language	yre	8	su:"Yaoure language"
Nenets language	yrk	68	su:"Nenets language"
Forest Nenets language	yrk	0	su:"Forest Nenets language"
Sirinek language	ysr	1	su:"Sirinek language"
Yessan-Mayo language	yss	30	su:"Yessan-Mayo language"
Yuchi language	yuc	9	su:"Yuchi language"
Havasupai language	yuf	16	su:"Havasupai language"
Hualapai language	yuf	19	su:"Hualapai language"
Yavapai language	yuf	14	su:"Yavapai language"
Yuruti language	yui	2	su:"Yuruti language"
Yuri language	yuj	10	su:"Yuri language"
Yuki language	yuk	8	su:"Yuki language"
Yulu language	yul	3	su:"Yulu language"
Yupa language	yup	4	su:"Yupa language"
Yurok language	yur	40	su:"Yurok language"
Yopno language	yut	3	su:"Yopno language"
Yugh language	yuu	1	su:"Yugh language"
Eastern Yugur language	yuy	6	su:"Eastern Yugur language"
Yuracare language	yuz	10	su:"Yuracare language"
Yawa language	yva	12	su:"Yawa language"
Yau language	yyu	27	su:"Yau language"
Zaghawa language	zag	7	su:"Zaghawa language"
Zanaki language	zak	2	su:"Zanaki language"
Zapotec language	zap	240	su:"Zapotec language"
Zenaga language	zen	9	su:"Zenaga language"
Kinga language	zga	2	su:"Kinga language"
Zhuang language	zha	72	su:"Zhuang language"
Chinese language	zho	84	su:"Chinese language"
Zigula language	ziw	9	su:"Zigula language"
Khorezmian Turkic language	zkh	9	su:"Khorezmian Turkic language"
Kott language	zko	1	su:"Kott language"
Zakhring language	zkr	1	su:"Zakhring language"
Khitan language	zkt	20	su:"Khitan language"
Kaurna language	zku	38	su:"Kaurna language"
Deli language	zlm	0	su:"Deli language"
Pasir language	zlm	1	su:"Pasir language"
Sambas language	zlm	0	su:"Sambas language"
Margany language	zmc	0	su:"Margany language"
Mituku language	zmq	1	su:"Mituku language"
Maranungku language	zmr	0	su:"Maranungku language"
Muruwari language	zmu	5	su:"Muruwari language"
Bomitaba language	zmx	1	su:"Bomitaba language"
Zande language	zne	48	su:"Zande language"
Zou language	zom	1	su:"Zou language"
Papabuco language	zpw	1	su:"Papabuco language"
Zaparo language	zro	16	su:"Zaparo language"
Zulu language	zul	1	su:"Zulu language"
Zuni language	zun	54	su:"Zuni language"
Zway language	zwa	3	su:"Zway language"
Zaza language	zza	24	su:"Zaza language"
