Ankave	aak
Afade	aal
Penobscot	aaq
Wawenock	aaq
Afar	aar
Abau	aau
Abo (Cameroon)	abb
Abidji	abi
Abkhaz	abk
Abung dialect	abl
Abua	abn
Abazin	abq
Tapanta	abq
Abron	abr
Ambonese Malay	abs
Abulas	abt
Abure	abu
Abaknon	abx
Aneme Wake	aby
Abui	abz
Achagua	aca
Cubulco Achi	acc
Achinese	ace
Acoli	ach
Achang	acn
Achi	acr
Achuar	acu
Achomawi	acv
Adangme	ada
Abor	adi
Bokar	adi
Milang	adi
Padam	adi
Bori	adi
Pailibo	adi
Adyukru	adj
Gallong	adl
Wailpi	adt
Amdo	adx
Adygei	ady
Chemgui	ady
Atsera	adz
Eastern Arrernte	aer
Alsea	aes
Amele	aey
Afrihili (Artificial)	afh
Afrikaans	afr
Awutu	afu
Senya	afu
Agarabe	agd
Anggor	agg
Argobba	agj
Agutaynon	agn
Paranan	agp
Aghem	agq
Aguaruna	agr
Agta	agt
Aguacatec	agu
Agul	agx
Ahanta	aha
Kemant	ahg
Quara	ahg
Kaw	ahk
Igo	ahl
Ahom	aho
Ahirani	ahr
Ahtena	aht
Arosi	aia
Aja (Sudan)	aja
Aja (Benin and Togo)	ajg
Ajie	aji
Akan	aka
Angkola	akb
Mpur language (Indonesia)	akc
Acawai	ake
Anakalang	akg
Angal Heneng	akh
Akkadian	akk
Aklanon	akl
Araki	akr
Akhwakh	akv
Alabama	akz
Mobilian trade language	akz
Alacaluf	alc
Aladian	ald
Aleut	ale
Alawa	alh
Alangan	alj
Larike-Wakasihu	alo
Alune	alp
Algonquin	alq
Alutor	alr
Areare	alu
Alyawarra	aly
Alur	alz
Amahuaca	amc
Amuesha	ame
Amarag	amg
Amharic	amh
Amis	ami
Ambai	amk
War	aml
Ama (Papua New Guinea)	amm
Amanab	amn
Alamblak	amp
Mashco	amr
Anmatyerre	amx
Ami language (Australia)	amy
Angas	anc
Anesu	ane
Goemai language	ank
Anal	anm
Obolo	ann
Andoque	ano
Angika	anp
Anuak	anu
Abe	any
Anyi	any
Brissa	any
Sanwi	any
Anem	anz
Arecuna	aoc
Camaracoto	aoc
Pemón	aoc
Taurepan	aoc
"Magi (Southern Highlands Province, Papua New Guinea)"	aoe
Andilyaugwa	aoi
Southern Arapesh	aoj
Aomie	aom
Saa	apb
Ulawa	apb
Mountain Arapesh	ape
Rai	aph
Athpare	aph
Jicarilla	apj
Chiricahua	apm
Mescalero	apm
Apma	app
Arop-Lokep	apr
Apatani	apt
Ipurina	apu
White Mountain Apache	apw
Western Apache	apw
Apalai	apy
Ampale	apz
Wojokeso	apz
Archi	aqc
Atakapa	aqp
Arabic	ara
Aramaic	arc
Arabana	ard
Aranda	are
Aragonese	arg
Cheso	arg
Ica	arh
Arikara	ari
Arabela	arl
Ranquel dialect	arn
Mapuche	arn
Moluche	arn
Pehuenche	arn
Araona	aro
Arapaho	arp
Karo (Brazil)	arr
Arbore	arv
Arawak	arw
Assiniboine	asb
American Sign Language	ase
Australian Sign Language	asf
Asilulu	asl
Assamese	asm
Asaro	aso
Asuri	asr
Bable	ast
Wasi	ata
Tsaiwa	atb
Ata Manobo	atd
Attie	ati
Atikamekw	atj
Atsina	ats
Atta	att
Northern Altai	atv
Teleut	atv
Atsugewi	atw
Aneityum	aty
Huao	auc
Sabela	auc
Anuta	aud
Aulua	aul
Avaric	ava
Avestan	ave
Avikam	avi
Au	avt
Awadhi	awa
"Awa (Eastern Highlands Province, Papua New Guinea)"	awb
Aekyom	awi
Awabakal	awk
Agau	awn
Abipon	axb
Aka (Central African Republic)	axk
"Armenian, Middle"	axm
Xaragure	axx
Ayizo-gbe	ayb
Aymara	aym
Moro (South America)	ayo
Mai Brat	ayz
Afshar	azb
Azerbaijani	aze
Bambatana	baa
Baré	bae
Bashkir	bak
Kuvakan	bak
Baluchi	bal
Bambara	bam
Balinese	ban
Barasana del Norte	bao
Bantawa	bap
Basa	bas
Mbili	baw
Bamun	bax
Tunen	baz
Bariba	bba
Barai	bbb
Toba-Batak	bbc
Bandjoun	bbj
Bats	bbl
Bobo Fing	bbo
Gólo	bbp
Bai (China)	bca
Bamu River	bcf
Bariai	bch
Baule	bci
Bardi	bcj
Bunaba	bck
Banoni	bcm
Kaluli	bco
Babine	bcr
Kohumono	bcs
Biliau	bcu
Bacama	bcy
Basap	bdb
Bunama	bdd
Bade	bde
Baka	bdh
Budukh	bdk
Bajau	bdl
Buduma	bdm
Bende	bdp
Bahnar	bdq
Burunge	bds
Bakundu	bdu
Bankudu-Balue	bdu
Baham	bdw
Yugambeh?Bundjalung dialects	bdy
Bandjalang	bdy
Gidabal	bdy
Yugumbeh	bdy
Tsattine	bea
Bebele	beb
Byangsi	bee
Benabena	bef
Biali	beh
Bekati'	bei
Beja	bej
Belarusian	bel
Bemba	bem
Bengali	ben
Bembe (Congo (Brazzaville))	beq
Blagar	beu
Betawi	bew
Jur Modo	bex
Kuku	bfa
Bari	bfa
Bafut	bfd
British Sign Language	bfi
Bunak	bfn
Badaga	bfq
Balti	bft
Bonda	bfw
Bagheli	bfy
Marari	bfy
Bangaru	bgc
Deswali	bgc
Rathvi dialect	bgd
Bugun	bgg
Bangolan	bgj
Bagri	bgq
Tagabawa Manobo	bgs
Bugotu	bgt
Bhatri dialect	bgw
Banggai	bgz
Bhili	bhb
Bhalesi	bhd
Bhadrawahi	bhd
Binandere	bhg
Judeo-Tajik	bhh
Bahing	bhj
Bhojpuri	bho
Bimanese	bhp
Kolo	bhp
Binongko	bhq
Bara (Madagascar)	bhr
Biak	bhw
Numfor	bhw
Bada (Indonesia)	bhz
Bidiyo	bid
Biangai	big
Bihari	bih
Bikol	bik
Bini	bin
Bisorio	bir
Bislama	bis
Birhor	biy
Barngarla	bjb
Bijago	bjg
Bahinemo	bjh
Burji	bji
Kanauji	bjj
Banjarese	bjn
Banjar Hulu	bjn
Antaisaka	bjq
Betsimisaraka	bjq
Binumarien	bjr
Bakwé	bjw
Southern Bontoc	bkb
Eastern Bontoc	bkb
Baka (Cameroon and Gabon)	bkc
Binukid Manobo	bkd
Baki	bki
Brokpa	bkk
Berik	bkl
Kom (Cameroon)	bkm
Bakairi	bkq
Bakumpai	bkr
Bekwarra	bkv
Timor	bkx
Bungku	bkz
Siksika	bla
Bella Coola	blc
Atinggola	bld
Uki	bld
Balante	ble
Buol	blf
Bolia	bli
Bolongan	blj
Taungthu	blk
Biloxi	bll
Blang	blr
Balaesang	bls
Black Tai	blt
Balangao	blw
Ayta Mag Indi	blx
Balantak	blz
Bembe (Lake Tanganyika)	bmb
Bagirmi	bmi
Bote-Mahi	bmj
Boomu	bmq
Muinane	bmr
Burum (Papua New Guinea)	bmu
Central Bontoc	bnc
Banda (Indonesia)	bnd
Bintauna	bne
Benga	bng
Bobangi	bni
Bunun	bnn
Banton	bno
Bundeli	bns
Pawari	bns
Bangubangu	bnx
Bora	boa
Boni (Kenya and Somalia)	bob
Tibetan	bod
Boma (Congo)	boh
Bom	boj
Bole	bol
Birom	bom
Bororo (Brazil)	bor
Bosnian	bos
Bongo	bot
Bondei	bou
Botlikh	bph
Kaure	bpp
Koronadal Blaan	bpr
Bongu	bpu
Bishnupuriya	bpy
Baima	bqh
Bakhtiari	bqi
Mkaa'	bqz
Braj	bra
Baram	brd
Breton	bre
Bauré	brg
Brahui	brh
Kwiri	bri
Barambu	brm
Boruca	brn
Tutong	bsb
Bassari	bsc
Bashgali	bsh
Burushaski	bsk
Werchikwar	bsk
Barasana del Sur	bsn
Taiwano	bsn
Bassa (Liberia and Sierra Leone)	bsq
Bakossi	bss
Basketo	bst
Baiso	bsw
Dii	bta
Bati	btc
Dairi Pakpak	btd
Biatah	bth
Simelungun	bts
Karo-Batak	btx
Alas	btz
Kluet	btz
Buriat	bua
Tobote	bud
Beothuk	bue
Bushoong	buf
Bugis	bug
Bukawa	buk
Bulgarian	bul
Bulu	bum
Sherbro	bun
Buin	buo
Budu	buu
Bubi language (Gabon)	buw
Northern Bullom	buy
Bube	bvb
Birri	bvq
Burarra	bvr
Meratus	bvu
Bauzi	bvz
Bwaidoga	bwd
Rue	bwg
Baniwa	bwi
Balong	bwt
Buli	bwu
Benge	bww
Bwamu	bww
Bor (Lwo)	bxb
Ongota	bxe
Bayungu	bxj
Bukusu	bxk
Batak	bya
Batak (Philippines)	bya
Bete	byf
Bidjara	bym
Bilin	byn
Baruya	byr
Medumba	byv
Baining	byx
Gbandi	bza
Bribri	bzd
Boiken	bzf
Yangoru	bzf
Favorlang	bzg
Biri (Australia)	bzr
Chorti	caa
Black Carib	cab
Caddo	cad
Chulupí	cag
Carolinian	cal
Camuhi	cam
Chambri	can
Chacobo	cao
Chipaya	cap
Car Nicobarese	caq
Carib	car
Chimane	cas
Moseten	cas
Catalan	cat
Cavineño	cav
Callahuaya	caw
Chiquito	cax
Cayuga	cay
Canichana	caz
Carapana (Tucanoan)	cbc
Cayapa	cbi
Chabacano	cbk
Nyah Kur	cbn
Cashibo	cbr
Cashinawa	cbs
Chayahuita	cbt
Candoshi	cbu
Cacua	cbv
Chamicuro	ccc
Chopi	cce
Chamba Daka	ccg
Chakma	ccp
Chambiali	cdh
Chepang	cdm
Cebuano	ceb
Chamacoco	ceg
Czech	ces
Laizo (Burma)	cfm
Falam Chin	cfm
Kagayanen	cgc
Chiga	cgg
Chamorro	cha
Chibcha	chb
Catawba	chc
Akka	che
Chechen	che
Chagatai	chg
Chinook	chh
Cahuilla	chl
Choctaw	cho
Chipewyan	chp
Cherokee	chr
Chumash	chs
Cholon	cht
Church Slavic	chu
Chuvash	chv
Chuwabo	chw
Chantel	chx
Cheyenne	chy
Ozumacín	chz
Cia-cia	cia
Chickasaw	cic
Chimariko	cid
Chinali	cih
Cimbrian	cim
Chiapanec	cip
Tinrin	cir
Amikwa	ciw
Upper Chehalis	cjh
Chamalal	cji
Chokwe	cjk
Cabecar	cjp
Mangue	cjr
Shor	cjs
Chuave	cjv
Khumi Awa	cka
Mukri	ckb
Anufo	cko
Tayo	cks
Chukchi	ckt
Koasati	cku
Ron	cla
Idu	clk
Mishmi	clk
Clallam	clm
Caluyanun	clu
Maa (Vietnam)	cma
Maa (Southeastern Asia)	cma
Chamí	cmi
Biat	cmo
Central Mnong	cmo
Messapian	cms
Chinbon	cnb
Haka Chin	cnh
Campa	cni
Khumi	cnk
Ahraing Khumi	cnk
Ngaun	cnw
Cocopa	coc
Cocama	cod
Coreguaje	coe
Colorado	cof
Kumiai	coj
Comanche	com
Cofán	con
Akhmimic dialect	cop
Bohairic	cop
Coptic	cop
Sahidic	cop
Coquille	coq
Cornish	cor
Corsican	cos
Caquinte	cot
Chocho	coz
Island Carib	crb
Lonwolwol	crc
Cree	cre
Michif	crg
Crimean Tatar	crh
Cora	crn
Crow	cro
Choroti	crt
Chrau	crw
Carrier	crx
Kashubian	csb
Slovincian	csb
Chilean Sign Language	csg
Khyang	csh
Bodega Miwok	csi
Diola Kasa	csk
Esuulaalu	csk
Chinese Sign Language	csl
Costa Rican Sign Language	csr
Mutsun	css
Siyin	csy
Coos	csz
Tiddim Chin	ctd
Chitimacha	ctm
Catio	cto
Cua	cua
Cubeo	cub
Cuiba	cui
Sicuane	cui
Chontaquiro	cuj
Cuna	cuk
Cueva	cuk
Culina	cul
Cupeño	cup
Ya	cuu
Kwatay	cwt
Cayuvava	cyb
Welsh	cym
Cuyunon	cyo
Zotung	czt
Dangaleat	daa
Ham	dad
Dan	daf
Dagbani	dag
Day (Chad)	dai
Dakota	dak
Santee	dak
Yankton	dak
Dahalo	dal
Danish	dan
Dafla	dap
Tagin	dap
Dargwa	dar
Kubachi	dar
Dabida	dav
Taita	dav
Edopi	dbf
Begak	dbj
Djirbal	dbl
Daba	dbq
Dakhini	dcc
Fataluku	ddg
Djaru	ddj
Dendi	ddn
Dido	ddo
Dedua	ded
Degema	deg
Delaware	del
Chutiya	der
Desana	des
German	deu
Dengese	dez
Dumagat (Casiguran)	dgc
Wule	dgi
Dogri	dgo
Dogrib	dgr
Daga	dgz
Jaipuri	dhd
Wan'guri	dhg
Dhimal	dhi
Dhalandji	dhl
Himba	dhm
Dhodia	dho
Dargari	dhr
Dhurga	dhu
Dehu	dhv
Danuwar Rai	dhw
Vata	dic
Diyari	dif
Digo	dig
Li	dij
Dinka	din
Padang	dip
Dimasa	dis
Diriku	diu
Divehi	div
Ding	diz
Ngaliwuru	djd
Zarma	dje
Djinang	dji
Ndjebbana	djj
Djuka	djk
Boni (French Guiana and Suriname)	djk
Jamsay dialect	djm
Bor (Dinka)	dks
Dolgan	dlg
Dalmatian (Romance)	dlm
Vegliote	dlm
Aduma	dma
Domaaki	dmk
Dampelasa	dms
Dungan	dng
Western Dani	dnw
Dobu	dob
Dompago	dop
Doyayo	dow
Gedeo	drs
Badakhshani	drw
Darai	dry
Lower Sorbian	dsb
Dutch Sign	dse
Danish Sign Language	dsl
Dagur	dta
Duala	dua
Duna	duc
Dukawa	dud
Dumagat (Umirey)	due
Dumbea	duf
Duruma	dug
Dungra Bhil	duh
Djapu	duj
Dusun Deyah	dun
Dupaninan Agta	duo
Dumi	dus
Tulung	duu
Dawawa	dww
Dyan	dya
Djimini	dyi
Diola	dyu
Dyula	dyu
Daza	dzd
Dzongkha	dzo
Embu	ebu
Eteocretan	ecr
Efik	efi
Eggon	ego
Egyptian	egy
Eipo	eip
Ekajuk	eka
Kapauku	ekg
Koti	eko
Ekpeye	ekp
Elamite	elx
Embaloh	emb
Emerillon	eme
Mascoi	emo
Koniagmiut	ems
Pacific Gulf Yupik	ems
Chugach	ems
English	eng
Engenni	enn
Enggano	eno
Enga	enq
Oron	enw
Atisa	epi
Eromanga	erg
South Efate	erk
Erre	err
Ese Ejja	ese
Esselen	esq
Yuit	ess
Estonian	est
Setu	est
Mulgi	est
Karksi	est
Aglemiut	esu
Central Yupik	esu
Eton	eto
Edolo	etr
Etsako	ets
Etruscan	ett
Ejagham	etu
Basque	eus
Even	eve
Evenki	evn
Solon	evn
Ewe	ewe
Ewondo	ewo
Eyak	eya
Fasu	faa
Annobon	fab
Faiwol	fai
Fang	fan
Faroese	fao
Falor	fap
Persian	fas
Fanti	fat
Quebec Sign	fcs
Mahas-Fiyadikka	fia
Fijian	fij
Filipino	fil
Finnish	fin
Izere	fiz
Kalispel	fla
Fali	fli
Kifuliru	flr
Fuliru	flr
Fe'fe'	fmp
Foi	foi
Fon	fon
Fore	for
French	fra
Cajun French	frc
Fordata	frd
Vaudois	frp
Futuna	fud
Pular	fuf
Fula	ful
Fulnio	fun
Friulian	fur
Futuna-Aniwa	fut
Furu	fuu
Bororo (West Africa)	fuv
Fuyuge	fuy
Fur	fvr
Gã	gaa
Gabri	gab
Gaddang	gad
Arekena	gae
Gagauz	gag
Gahuku	gah
Gadsup	gaj
Galoli	gal
Gata'	gaq
Adiwasi Garasia	gas
Gadaba (Dravidian)	gau
Halopa	gaw
Boran	gax
Gayo	gay
Gbaya	gba
Kaytetye	gbb
Garawa	gbc
Sawos	gbf
Galela	gbi
Gadaba (Munda)	gbj
Gadi	gbk
Gamit	gbl
Garhwali	gbm
Parvati	gbm
Gbagyi	gbr
Gagadu	gbu
Gbari	gby
Gedaged	gdd
Gude	gde
Yaghwatadaxa	gdf
Laal	gdm
Gwedena	gdn
Godoberi	gdo
Mahri	gdq
Gade	ged
Gen-Gbe	gej
Enya	gey
Ethiopic	gez
Pala	gfk
Gafat	gft
Gagu	ggu
Gogodala	ggw
Guhu-Samane	ghs
Kitja	gia
Gidar	gid
Gilbertese	gil
Gimi	gim
Ginukh	gin
Gonja	gjn
Gujuri	gju
Gokana	gkn
Nanai	gld
Irish	gle
Galician	glg
Kùláál	glj
Gilaki	glk
Glosa (Artificial)	gls
Manx	glv
Glavda	glw
Gamo	gmo
Gangte	gnb
Guanche	gnc
Zulgo	gnd
Mi Gangam	gng
Lyele	gnh
Gunian	gni
G//ana	gnk
Gumatj	gnn
Gureng Gureng	gnr
Kweni	goa
Dadjriwale? dialect	god
Godie?	god
Gogo	gog
Gola	gol
Chitapavani	gom
Kudali	gom
Gondi	gon
Gorontalo	gor
Tilamuta	gor
Gothic	got
Grebo	grb
Greek	grc
Attic Greek	grc
Doric Greek	grc
Ionic Greek	grc
Aeolic Greek	grc
Ma	grg
Vaturanga	gri
Jabo	grj
Guarani	grn
Garo	grt
Goajiro	guc
Gupapuyngu	guf
Guahibo	guh
Chiriguano	gui
Gujarati	guj
Parsi-Gujarati	guj
Sea Islands Creole	gul
Moguex	gum
Mbya	gun
Guayabero	guo
Gunwinggu	gup
Guayaki	guq
Frafra	gur
Guatuso	gut
Yanomamo	guu
Gun-Gbe	guw
Gurma	gux
Gusii	guz
Guanano	gvc
Golin	gvf
Marigl	gvf
Kuku-Yalanji	gvn
Zoró	gvo
Tamu	gvr
Gumasi	gvs
Gwich'in	gwi
G/wi	gwj
Gwandara	gwn
Gwere	gwr
Gwa (Ghana)	gwx
Yaayuwee	gya
Gayardilt	gyd
Gungabula	gyf
Bagyele	gyi
Guaymi	gym
Guarayo	gyr
Gorani	hac
Hatam	had
Qottu	hae
Hanga (Ghana)	hag
Haida	hai
Hangaza	han
Ha	haq
Harari	har
Haisla	has
Hausa	hau
Uwana	hau
Hawaiian	haw
Haya	hay
Hazara	haz
Serbo-Croatian	hbs
Huichol	hch
Hadiya	hdy
Black Hmong	hea
Hehe	heh
Heiltsuk	hei
Oowekyala	hei
Herero	her
Laamang	hia
Hidatsa	hid
Fiji Hindi	hif
Kamwe	hig
Hiligaynon	hil
Himachali	him
Hindi	hin
Khari Boli	hin
Hittite	hit
Luwian	hit
Hixkaryana	hix
Hunde	hke
Halia	hla
Halbi	hlb
Hua Hmong	hmd
Hmong	hmn
Hiri Motu	hmo
Hmar	hmr
Kapau	hmt
Chattisgarhi	hne
Hani	hni
Hmong Njua	hnj
Hanunóo	hnn
Suriname Hindustani	hns
Ho	hoc
Harauti	hoj
Holu	hol
Holoholo	hoo
Hopi	hop
Hre	hre
Haroi	hro
Croatian	hrv
Cakavian	hrv
Kajkavian	hrv
Upper Sorbian	hsb
Harsusi	hss
Huambisa	hub
!Xõ	huc
Huli	hui
Hula	hul
Hungana	hum
Hungarian	hun
Székely	hun
Hupa	hup
Chilliwack	hur
Stalo	hur
Murui	huu
Hunzib	huz
Sawu	hvn
Armenian	hye
"Armenian, Modern"	hye
East Armenian	hye
West Armenian	hye
Iai	iai
Iatmul	ian
Purari	iar
Iban	iba
Ibibio	ibb
Iwaidji	ibd
Ibanag	ibg
Ibaloi	ibl
Igbo	ibo
Ngwa	ibo
Ibani	iby
Icelandic Sign Language	icl
Idakho-Isukha-Tiriki	ida
Idaca	idd
Idaté	idt
Idoma	idu
Amganad Ifugao	ifa
Batad Ifugao	ifb
Ayangan Ifugao	ifb
Tuwali	ifk
Kiangan Ifugao	ifk
Mayoyao Ifugao	ifu
Keley-i Kallahan	ify
Ebira	igb
Igede	ige
Igala	igl
Mojo	ign
Interglossa (Artificial)	igs
Iha	ihp
Ijo	ijc
Kolokuma	ijc
Kalabari	ijn
Nembe	ijs
Inuvialuktun	ikt
Kopagmiut	ikt
Inuktitut	iku
Ikwere	ikw
Ik	ikx
Ila	ilb
Occidental (Artificial)	ile
Ilongot	ilk
Iloko	ilo
Imbo Ungu	imo
Indonesian	ind
Deg Hit'an	ing
Ingush	inh
Ingano	inj
Indonesian Sign	inl
Minaean	inm
Isinay	inn
Inoke	ino
Inapari	inp
Inor	ior
Irumu	iou
Iowa	iow
Oto	iow
Ipili	ipi
Inupiaq	ipk
Iquito	iqu
Irahutu	irh
Iraqw	irk
Iranxe	irn
Münkü	irn
Irula	iru
Kasaba	iru
Mangyan	iry
Isneg	isd
Italian Sign	ise
Esan	ish
Icelandic	isl
Italian	ita
Itene	ite
Judeo-Italian	itk
Kamchadal	itl
Itonama	ito
Itsekiri	its
Itawis	itv
Itzá	itz
Yao (Southeastern Asia)	ium
Itbayat	ivb
Batan	ivv
Iwam	iwm
Ixcateco	ixc
Ingrian	izh
Ezaa	izi
Ikwo	izi
Izi	izi
Jarua?ra	jaa
Yabim	jae
Jah Hut	jah
Yanyuwa	jao
Yaqay	jaq
Javanese	jav
Banten	jav
Tegal	jav
Jebel Nefusa	jbn
Shilha	jbn
Lojban (Artificial)	jbo
Jukun	jbu
Judeo-Tat	jdt
Jeh	jeh
Jeli	jek
Ngomba (Bamileke)	jgo
Jicaque	jic
Djingili	jig
Jita	jit
Shuar	jiv
Yamdena	jmd
Yemsa	jnj
Jaunsari	jns
Japanese	jpn
Judeo-Persian	jpr
Cauqui	jqr
Jarai	jra
Judeo-Arabic	jrb
Jurchen	juc
Jirel	jul
Juang	jun
Jupda	jup
Yuruna	jur
Gyarung	jya
Kara-Kalpak	kaa
Kabyle	kab
Kachin	kac
Kara (Central African Republic and Sudan)	kah
Kaje	kaj
Kayapa Kallahan	kak
Kalâtdlisut	kal
Ammassalimiut	kal
Kamba	kam
Kannada	kan
Jenukuruba	kan
Kassonke	kao
Bezhta	kap
Capanahua	kaq
Kashmiri	kas
Adzhar	kat
Georgian	kat
Gurian	kat
Imeretian	kat
Ingilo	kat
Kanuri	kau
Kawi	kaw
Katu	kax
Kamaiurá	kay
Kazakh	kaz
Mbaya	kbc
Kabardian	kbd
Camsa	kbh
Kare	kbj
Koiari	kbk
Kanembu	kbl
Kaiwa (Papua New Guinea)	kbm
Karré	kbn
Kabre	kbp
Kamano	kbq
Kaffa	kbr
Khanty	kca
Southern Khanty	kca
Northern Khanty	kca
Kagoro (Nigeria)	kcg
Katab	kcg
Lilima	kck
Kalanga (Botswana and Zimbabwe)	kck
Nubi	kcn
Kete	kcv
Kattang	kda
Makonde	kde
Tem	kdh
Karamojong	kdj
Kapone	kdk
Kagoma	kdm
Karaim	kdr
Kui (Mon-Khmer)	kdt
Kadu	kdv
Cape Verde Creole	kea
Kele	keb
Kerebe	ked
Kekchi	kek
Kela	kel
Kemak	kem
Anyang	ken
Kakwa	keo
Kera	ker
Ket	ket
Kupia	key
Kodagu	kfa
Konda	kfc
Kota (India)	kfe
Koya	kff
Kurumba	kfi
Kanauri	kfk
Korwa	kfp
Kurku	kfq
Kachchhi	kfr
Bilaspuri	kfs
Kului	kfx
Kumauni	kfy
Komering	kge
Kayu Agung	kge
Kusunda	kgg
Upper Tanudan Kalinga	kgh
Caingua	kgk
Krongo	kgo
Kaingang	kgp
Kamoro	kgq
Abun	kgr
Kumbainggar	kgs
Khasi	kha
Lü	khb
Korowai	khe
Khalkha	khk
Lusi	khl
Khandesi	khn
Khotanese	kho
Delki Khadia dialect	khr
Kharia	khr
Khamti	kht
Khvarshi	khv
Khowar	khw
Lokele	khy
Koalib	kib
Nirere	kib
Kickapoo	kic
Kiriwinian	kij
Kikuyu	kik
Tofa	kim
Kinyarwanda	kin
Kiowa	kio
Kyrgyz	kir
Gope	kiw
Northeastern Kiwai	kiw
Khiamniungan	kix
Kissi	kiz
Kanjobal	kjb
Kisar	kje
Khalaj	kjf
Khmu'	kjg
Khinalugh	kjj
Acoma	kjq
Laguna	kjq
Kashaya	kju
Khün	kkh
Kaguru	kki
Sagara	kki
Kako	kkj
Kokota	kkk
Kosarek	kkl
Karko	kko
Kukwa	kkw
Seruyan	kkx
Guguyimidjir	kky
Klamath	kla
Kiliwa	klb
Kamilaroi	kld
Kulung	kle
Sotang Kura	kle
Tagakaolo	klg
Kalenjin	kln
Kipsikis	kln
Nandi	kln
Kairi	klq
Khaling	klr
Kalash	kls
Kru	klu
Kimbundu	kmb
Kâte	kmg
Kalam	kmh
Lower Tanudan Kalinga	kml
Kom (India)	kmm
Washkuk	kmo
Kamasau	kms
Kamtuk	kmt
Kanite	kmu
Karipuna Creole	kmv
Komo (Congo)	kmw
Kanakuru	kna
Kankanay	kne
Mankanya	knf
Koongo (Western Kongo)	kng
Akatek	knj
Kuranko	knk
Agri	knn
Kunabi	knn
Semang	kns
Kung-Ekoka	knw
Dayak	knx
Kagaba	kog
Komi-Permyak	koi
Konkani	kok
Komi	kom
Kongo	kon
Konjo	koo
Korean	kor
Kusaie	kos
Koyukon	koy
Curripaco	kpc
Kpelle	kpe
Komba	kpf
Kapingamarangi	kpg
Kreish	kpl
Srê	kpm
Koho	kpm
Kposo	kpo
Korape	kpr
Tehit	kps
Karata	kpt
Komi-Yaz'va	kpv
Kobon	kpw
Mountain Koiari	kpx
Koryak	kpy
Palan	kpy
Kalagan	kqe
Kaonde	kqn
Tchien	kqo
Korana	kqz
Kumali	kra
Karachay-Balkar	krc
Krio	kri
Kinaray-a	krj
Karelian	krl
Kurukh	kru
Kisan language (Dravidian)	kru
Kurukh	kru
Shambala	ksb
Southern Kalinga	ksc
Tolai	ksd
Bafia	ksf
Uare	ksj
Kwami	ksq
Kusu	ksv
Sgaw Karen	ksw
Kedang	ksx
Kambata	ktb
Qebena dialect	ktb
Gugada	ktd
Kalkatungu	ktg
Karanga	kth
Karitiana	ktn
Kituba	ktu
Kato	ktw
Kuanyama	kua
Kurada	kud
Kipchak	kue
Kuria	kuj
Kumyk	kum
Kunama	kun
Hazili	kup
Kunimaipa	kup
Kurdish	kur
Kusaal	kus
Kutenai	kut
Upper Kuskokwim	kuu
Kukatja	kux
Kuuku Ya'u	kuy
Atacameno	kuz
Bagulal	kva
Kubu	kvb
Komodo	kvh
Dobel	kvo
Kerinci	kvr
Akit	kvr
Kwaio	kwd
Kwerba	kwe
Kwara'ae	kwf
Cuaiquer	kwi
Kwakiutl	kwk
Kwangali	kwn
Kwese	kws
Kwakum	kwu
Kui	kxu
Kuvi	kxv
Ruri	kya
Kyaka	kyc
Karok	kyh
Karao	kyj
Kalapuya	kyl
Kenga	kyq
Kurmali	kyw
Kayabi	kyz
Auyana	kze
Kosena	kze
Daa	kzf
Dongola-Kenuz	kzh
Kaike	kzq
Karang (Cameroon)	kzr
Kariri	kzw
Kalabra	kzz
Southern Subanen	laa
Lacandon	lac
Hakétia	lad
Ladino	lad
Chamba Lahuli	lae
Pattani (India)	lae
Rangi	lag
Lahnda	lah
Lamba (Zambia and Congo)	lam
Lao	lao
Laqua	laq
Latin	lat
Latvian	lav
Tiwa	lax
Aribwatsa	laz
Lak	lbe
Lahuli	lbf
Ladakhi	lbj
Laven	lbo
Wampar	lbq
Tolaki	lbw
Mekongga	lbw
Pasir (Lawangan)	lbx
Lawangan	lbx
Bawo (Indonesia)	lbx
Lamalama	lby
Lardil	lbz
Lucazi	lch
Lavongai	lcm
Laadi	ldi
Ambo (Zambia)	leb
Bisa	leb
Lendu	led
Lefana	lef
Lengua	leg
Lenje	leh
Nomaante	lem
Lenca	len
Lepcha	lep
Lese	les
Kara (Papua New Guinea)	leu
Lamma	lev
Sigi	lew
Letri lgona	lex
Lezgian	lez
Lugbara	lgg
Longgu	lgu
Lhomi	lhm
Lahu Bakeo dialect	lhu
Lahu	lhu
Ulithi	li
Lindrou	lid
Limbu	lif
Ligbi	lig
Lika	lik
Lillooet	lil
Limburgish	lim
Lisu	lis
Hua Lisu	lis
Lithuanian	lit
Livonian	liv
Lembak Bilide	liw
Sindang Kelingi	liw
Banda	liy
Linda	liy
Mbinsa	liz
Lampung	ljp
Ranau	ljp
Laha (Vietnam)	lkh
Laki language (Iran)	lki
Lakona	lkn
Lakota	lkt
Ladin	lld
Lele (Chad)	lln
North Efate	llp
Lolak	llq
Lau	llu
Limilngan	lmc
Lamé (Cameroon)	lme
Hano	lml
Lambadi	lmn
Lombard	lmo
Limbum	lmp
Lango	lno
Lamnso'	lns
Guyuk	lnu
Longuda	lnu
Logo	log
Lou	loj
Loko	lok
Mongo-Nkundu	lol
Ekonda	lol
Loma	lom
Lomwe language (Malawi)	lon
Téén	lor
Lorhon	lor
Loniu	los
Lotuko	lot
Lopa (Nepal)	loy
Lozi	loz
Larrakia	lrg
Leko	lse
Losengo	lse
Lashi	lsi
Luxembourgish	ltz
Luba-Lulua	lua
Luba-Katanga	lub
Ludic	lud
Luvale	lue
Ganda	lug
Luiseño	lui
Lunda	lun
Luo (Kenya and Tanzania)	luo
Lumbu (Gabon)	lup
Lushai	lus
Nisqually	lut
Hanga (Kenya)	luy
Kisa	luy
Luyia	luy
Maku'a (Indonesia)	lva
Lavukaleve	lvk
Lwo (Sudan)	lwo
Luyana	lyn
Laz	lzz
Madurese	mad
Mafa	maf
Magahi	mag
Marshallese	mah
Maithili	mai
Khotta	mai
Makasar	mak
Malayalam	mal
Moplah	mal
Mandingo	man
Jha?d?i? dialect	mar
Koshti (Marathi)	mar
Marathi	mar
Are dialect	mar
Kwafi	mas
Masai	mas
Matlatzinca	mat
Maue	mav
Mampruli	maw
Higaonon	mba
Western Bukidnon Manobo	mbb
Macusi	mbc
Dibabawon	mbd
Mangseng	mbh
Ilianen Manobo	mbi
Masacali	mbl
Macaguan	mbn
Mbo (Cameroon)	mbo
Damana	mbp
Maisin	mbq
Macú	mbr
Sarangani Manobo	mbs
MatigSalug	mbt
Maring	mbw
Maca	mca
Machiguenga	mcb
Sharanahua	mcd
Mayoruna	mcf
Yecuana	mch
Mbunda (Angola and Zambia)	mck
Kristang	mcm
Masa (Chadic)	mcn
Maka (Cameroon)	mcp
Managalasi	mcq
Mpiemo	mcx
Gbete dialect	mdd
Mbum	mdd
Maba	mde
Moksha	mdf
Magindanao	mdh
Mamvu	mdi
Mangbetu	mdj
"Mbala (Bandundu, Congo)"	mdp
Mandar	mdr
Mbete	mdt
Mbosi	mdw
Dizi	mdx
Male (Ethiopia)	mdy
Mara (Australia)	mec
Medlpa	med
Midob	mei
Meax	mej
Mekeo	mek
Mangala	mem
Mende	men
Meru	mer
Motu	meu
Mano	mev
Hassaniyya dialect	mey
Menominee	mez
Pattani (Thailand)	mfa
Lom	mfb
Malgwa	mfi
Wandala	mfi
Moba	mfq
Mexican Sign	mfs
Mandjak	mfv
Mayo (Piman)	mfy
Maban	mfz
Moru	mgd
Migili	mgi
Mambai	mgm
Meta language (Cameroon)	mgo
Mambwe	mgr
Mambwe-Lungu	mgr
Lungu	mgr
Mailu	mgu
Matumbi	mgw
Mbugwe	mgz
Mochó	mhc
Mbugu	mhd
Besisi	mhe
Ma'di (Uganda and Sudan)	mhi
Moghol	mhj
Mungaka	mhk
Mandan	mhq
Buru	mhs
Digaro	mhu
Mbukushu	mhw
Maru	mhx
Maanyan	mhy
Illinois	mia
Miami (Ind. and Okla.)	mia
Micmac	mic
Mandaean	mid
Southern Mofu	mif
Hitchiti	mik
Mikasuki	mik
Minangkabau	min
Jamee	min
Mukomuko	min
Miskito	miq
Mongour	mjg
Mandeali	mjl
Malto	mjt
Mikir	mjw
Mahican	mjy
Macedonian	mkd
Miya	mkf
Mokilese	mkj
Moklen	mkm
East Makian	mky
Makasai	mkz
Manambu	mle
Taimoro	mlg
Malagasy	mlg
Mulao	mlm
Mugil	mlp
Maltese	mlt
To'abaita	mlu
Motlav	mlv
Malfaxal	mlx
Maonan	mmd
Mamanwa	mmn
Mandak	mmx
Jongor	mmy
Mangap	mna
Muna	mnb
Mawasangka	mnb
Manchu	mnc
Mundani	mnf
Eastern Mnong	mng
Mono (Congo)	mnh
Manipuri	mni
Munji	mnj
Mansi	mns
Rennellese	mnv
Mon	mnw
Muana	moa
Montagnais	moe
Mohegan	mof
Narragansett	mof
Bolaang Mongondow	mog
Mohawk	moh
Monjombo	moj
Mongolian	mon
Mopan	mop
Moro (Sudan)	mor
Yana (Burkina Faso and Togo)	mos
Mooré	mos
Motilon	mot
Mohave	mov
Molima	mox
Mocha	moy
Mokulu	moz
Mullukmulluk	mpb
Mangarayi	mpc
Majang	mpe
Maung	mph
Mandjildjara	mpj
Martu Wangka	mpj
Mbara (Chad)	mpk
Daribi	mps
Mianmin	mpt
Misima	mpx
Misima-Panayati	mpx
Panayati	mpx
Mbuko	mqb
Mbelime	mql
Moronene	mqn
West Makian	mqs
Mouk	mqt
Manggarai (Indonesia)	mqy
Mlabri	mra
Maricopa	mrc
Lakher	mrh
Maori	mri
Mortlockese	mrl
Cheke Holo	mrn
Nukahiva	mrq
Abujhmaria	mrr
Madiya-Gondi	mrr
Mangareva	mrv
Lanao Moro	mrw
Maranao	mrw
Masbateno	msb
Musei	mse
Masikoro	msh
Mansaka	msk
Agusan Manobo	msm
Musom	msu
Cotabato Manobo	mta
Mono-Alu	mte
Una	mtg
Mator	mtm
Muong	mtq
Mewari	mtr
Mota	mtt
Mundang	mua
Musgu	mug
Vulum	mug
Mpus	mug
Mundu (Sudan and Congo)	muh
Penesak	mui
Musi	mui
Rawas	mui
Lematang	mui
Malvi	mup
Murle	mur
Creek	mus
Seminole	mus
Muduva	muv
Miyemu	mux
Manam	mva
Mattole	mvb
Ordos	mvf
Chahar	mvf
Minaveha	mvn
Marovo	mvo
Maiya	mvy
Mesqan	mvz
Mukawa	mwc
Mudburra	mwd
Murrinhpatha	mwf
Labo	mwi
Mirandese	mwl
Majingai	mwm
Mabuiag	mwp
Mün Chin	mwq
Dingal	mwr
Marwari	mwr
Moken	mwt
Mentawai	mwv
White Hmong	mww
Manyika	mxc
Mele-Fila	mxe
Miju	mxj
Monumbo	mxk
Maxi	mxl
Mada (Cameroon)	mxu
Mau	mxx
Munduruku	my
Burmese	mya
Mbai (Moissala)	myb
Mpongwe	mye
Mamara	myk
Mura	myp
Pirahá	myp
Munichi	myr
Muyuw	myw
Gisu	myx
Macuna	myy
Mzab	mzb
Mumuye	mzm
Movima	mzp
Mori	mzq
Mo (Côte d'Ivoire and Ghana)	mzw
Narak	nac
Nabak	naf
Nahuatl	nah
Nakanai	nak
Nalik	nal
Ngankikurungkurr	nam
Nama	naq
Kongara	nas
Nauru	nau
Navajo	nav
Narrinyeri	nay
Ganguela	nba
Chang	nbc
Konyak	nbe
Naxi	nbf
Mao Naga	nbi
Ngarinyman	nbj
Ndebele (South Africa)	nbl
Ngbaka ma'bo	nbm
Rongmei	nbu
Wangkumara (Galali)	nbx
Nahu	nca
Nancowry	ncb
Notsi	ncf
Niska	ncg
Nakara	nck
Sibo	nco
Nicaraguan Sign	ncs
Chothe Naga	nct
Nchumburu	ncu
Natchez	ncz
Taensa	ncz
Ndau	ndc
Ndebele (Zimbabwe)	nde
Ndali	ndh
Samba Leko	ndi
Ndonga	ndo
Ndunga	ndt
Tura	neb
Kumak	nee
Negidal	neg
Nemi	nem
Nengone	nen
Baitadi dialect	nep
Nepali	nep
Nyaheun	nev
Newari	new
Pahri	new
Dolakha	new
Nez Percé	nez
Ayiwo	nfl
Nafaanra	nfr
Ngombe	ngc
Doko (Congo)	ngc
Ngemba (Cameroon)	nge
Mankon	nge
Khomani	ngh
Ngizim	ngi
Lomwe language (Mozambique)	ngl
Ngatik	ngm
Ngoni language (Tanzania and Mozambique)	ngo
Beng	nhb
Chiripá	nhd
Takuu	nho
Nharo	nhr
Noone	nhu
Nias	nia
Ngandi	nid
Nielim	nie
Ngalakan	nig
Nyiha	nih
Nii	nii
Ngaju	nij
Katingan	nij
Kahayan	nij
Nilamba	nim
Nganasan	nio
Nimboran	nir
Niuean	niu
Gilyak	niv
Ngiti	niy
Nocte	njb
Lhota	njh
Tenyidie dialect	njm
Angami	njm
Liangmai Naga	njn
Ao	njo
Ngadju (Australia)	nju
Nkoya	nka
Khezha	nkh
Nogugu	nkk
Nkunya	nko
Nukuoro	nkr
Dutch	nld
Florida	nlg
Nihali	nll
Maram	nma
Big Nambas	nmb
Ngama	nmc
Ndumu	nmd
Tangkhul	nmf
Ukhrul	nmf
Bisio	nmg
Moshang	nmh
Namakura	nmk
Nambya	nmq
Nawdm	nmz
Nyangumarta	nna
Nande	nnb
Nancere	nnc
Ngyemboon	nnh
Nankina	nnk
Namia	nnm
Norwegian (Nynorsk)	nno
Wancho	nnp
Nanticoke	nnt
Nukunu	nnv
Waunana	noa
Northern Thai	nod
Nimadi	noe
Nogai	nog
Old Norse	non
Nootka	noo
Norwegian	nor
Nomatsiguenga	not
Notu	nou
Novial (Artificial)	nov
Nyambo	now
Phom	nph
Pochury	npo
Napu	npy
Baria	nrb
Rengma	nre
Chakhesang	nri
Ngarluma	nrl
Norn	nrn
Lala	nrz
Sangtam	nsa
Senga	nse
Naskapi	nsk
Sema	nsm
Nehan	nsn
Gananwa	nso
Lobedu	nso
Northern Sotho	nso
Northern Sierra Miwok	nsq
Nali	nss
Moklum	nst
Tangsa	nst
Lungchang	nst
Yogli	nst
Nisenan	nsz
Ngaanyatjara	ntj
Nateni	ntm
Ntomba	nto
Natanzi	ntz
Kombe	nui
Nung	nun
Nguôn	nuo
Nupe	nup
Nuer	nus
Tay-Nung	nut
Nunggubuyu	nuy
Nyabwa	nwb
Bangwa	nwe
Ngada	nxg
Ngawun	nxn
Chewa	nya
Nyanja	nya
Nyore	nyd
Giryama	nyf
Nyikina	nyh
Nyanga	nyj
Nyaneka	nyk
Nyamwezi	nym
Nyankole	nyn
Nyoro	nyo
Nyungwe	nyu
Nyulnyul	nyv
Ngonde	nyy
Nzebi	nzb
Nzima	nzi
Nzakara	nzk
Zeme	nzm
New Zealand Sign	nzs
Orok	oaa
Oroch	oac
Bagobo	obo
Manuvu	obo
Obo Manobo	obo
Ocaina	oca
Béarnais	oci
Gascon	oci
Occitan	oci
Ocuiltec	ocu
Odual	odu
Ofo	ofo
Kana	ogo
Ogbronuagum	ogu
Nipissing	ojc
Ojibwa	oji
"Japanese--Heian period, 794-1185"	ojp
Leuangiua	ojv
Colville	oka
Okanagan	oka
"Korean--Middle Korean, 935-1500"	okm
Korean--To 935	oko
Okrika	okr
Orokaiva	okv
Olonets	olo
Omaha	oma
Yunca	omc
Omi	omi
Ombo	oml
Ona	ona
Be	onb
Oneida	one
Olo	ong
Onondaga	ono
Ono	ons
Tohono O'Odham	ood
Pima	ood
Önge	oon
Oksapmin	opm
Eudeve	opt
Opata	opt
Orma	orc
Orejón	ore
Oroqen	orh
Oriya	ori
Sambalpuri	ori
Oromo	orm
Orokolo	oro
Adiwasi Oriya	ort
Ormuri	oru
Ormu	orz
Osage	osa
Oscan	osc
Osing	osi
Ossetic	oss
Old Saxon	osx
Ot Danum	otd
Old Turkic	otk
Ottawa	otw
Ouargla	oua
Wayampi	oym
Koozime	ozm
Oghuz	ozn
Paressi	pab
Pacoh	pac
Purupuru	pad
Pangasinan	pag
Parintintin	pah
Tenharim	pah
Pahlavi	pal
Pampanga	pam
Panjabi	pan
Northern Paiute	pao
Parya	paq
Panamint	par
Palauan	pau
Pakaasnovos	pav
Pawnee	paw
Paez	pbb
Panzaleo	pbb
Patamona	pbc
Paraujano	pbg
Panare	pbh
Paduko	pbi
Badyara	pbp
Pangwa	pbr
Kaili	pbz
Pear	pcb
Bouyei	pcc
Yay	pcc
Parji	pci
Parengi	pcj
Paite	pck
Pennsylvania German	pdc
Kayan	pdu
Peranakan Indonesian	pea
Eastern Pomo	peb
Pay	ped
Pengo	peg
Bonan	peh
Northern Pomo	pej
Pekal	pel
Pende	pem
Old Persian	peo
Petats	pex
Phalura	phl
Phoenician	phn
Pothwari	phr
Phu Thai	pht
Pima Bajo	pia
Piaroa	pid
Piro (Tanoan)	pie
Pingelap	pif
Pitcairnese	pih
Quioucohanock	pim
Powhatan	pim
Piapoco	pio
Pero	pip
Piratapuyo	pir
Pitta Pitta	pit
Pintupi	piu
Pileni	piv
Pitjantjatjara	pjt
Suk	pko
Paku	pku
Pilaga	plg
Pali	pli
Oluta	plo
Palaic	plq
Betsileo	plt
Palicur	plu
Paama	pma
Bareë	pmf
Pamona	pmf
Tuamotuan	pmt
Plains Miwok	pmw
Pinai-Hagahai	pnn
Panobo	pno
Ponosakan	pns
Banyjima	pnw
Pinyin	pny
Sierra Popoluca	poi
Polish	pol
Southeastern Pomo	pom
Ponape	pon
Central Pomo	poo
Portuguese	por
Sayula	pos
Potawatomi	pot
Crioulo	pov
Polabian	pox
Pogoro	poy
Paipai	ppi
Uma	ppk
Pipil	ppl
Folopa	ppo
Pelende	ppp
Asu	ppt
Passamaquoddy	pqm
Prussian	prg
Paici	pri
Provençal	pro
Dari	prs
Madaglashti	prs
Purik	prx
Ogan	pse
Semendo	pse
Serawai	pse
Besemah	pse
Enim	pse
Lintang	pse
Bengkulu	pse
Pauserna	psm
Portuguese Sign	psr
Kaulong	pss
Sauraseni	psu
Port Sandwich	psw
Patep	ptp
Puelche	pue
Puoc	puo
Puquina	puq
Pushto	pus
Punu	puu
Puluwat	puw
Pawaian	pwa
Gapapaiwa	pwg
Melebuganon	pwm
Paiwan	pwn
Powari	pwr
Fyam	pym
Quechua	que
Cañari	quf
Quileute	qui
Sipacapense	qum
Quinault	qun
Sacapulteco	quv
Huanca	qvw
Quenya (Artificial)	qya
Quinnipiac	qyp
Chamling	rab
Rade	rad
Western Meohang	raf
Logooli	rag
Rabha	rah
Rangdania	rah
Ramoaaina	rai
Rajasthani	raj
Canella	ram
Rao	rao
Rapanui	rap
Sami	raq
Mangaian	rar
Rarotongan	rar
Sampang	rav
Rawang	raw
Rembong	reb
"Rejang (Sumatra, Indonesia)"	rej
Rendille	rel
Rengao	ren
Rang Pas	rgk
Resigero	rgr
Roti	rgu
Rif	rif
Riang-lang	ril
Ritarungo	rit
Rajbangsi	rjs
Rikbaktsa	rkb
Arakanese	rki
Rama	rma
Rembarrnga	rmb
Roma	rmm
Caló (Romani)	rmr
Lovari	rmy
Ruund	rnd
Ronga	rng
Northern Roglai	rog
Raeto-Romance	roh
Romani	rom
Romanian	ron/rum
Rotokas	roo
Kriol	rop
Runga	rou
Roro (New Guinea)	rro
Ratahan	rth
Rotuman	rtm
Carpatho-Rusyn	rue
Roviana	rug
Moldavian	rum
Rundi	run
Istro-Romanian	ruo
Aromanian	rup
Russian	rus
Rutul	rut
Rawa	rwo
Bikaneri	rwr
Fox	sac
Sandawe	sad
Sango (Ubangi Creole)	sag
Yakut	sah
Sahu	saj
Samaritan Aramaic	sam
Sanskrit	san
Samburu	saq
Sasak	sas
Santali	sat
Sawi	saw
Saurashtri	saz
Gambai	sba
Mandegusu	sbb
Saliva	sbe
Safwa	sbk
Botolan Sambal	sbl
Sangu (Tanzania)	sbp
Subiya	sbs
Ruc	scb
Dongxiang	sce
Sadani	sck
Shina	scl
Scots	sco
Toraja	sda
Toraja Sa'dan	sda
Bukar Sadong	sdo
Sherdukpen	sdp
Semai	sea
Sechelt	sec
Sedang	sed
Seneca	see
Senari	sef
Tyembara	sef
Sena	seh
Seri	sei
Sekani	sek
Selkup	sel
Koyraboro Senni	ses
Sentani	set
Secoya	sey
South African Sign	sfs
Ayta Anchi Sambal	sgb
Bartang	sgh
Khuf	sgh
Shughni	sgh
Ishkashmi	sgl
Zebaki	sgl
Chaha	sgw
Sursurunga	sgz
Shoshoni	shh
Shilluk	shk
Shan	shn
Shipibo-Conibo	shp
Shi	shr
Shuswap	shs
Shasta	sht
Shauri	shv
Syènara	shz
Sidamo	sid
Mwenyi	sie
Pasaale	sig
Mende (Papua New Guinea)	sim
Sinhalese	sin
Dänjong-kä	sip
Siuslaw	sis
Siwai	siw
Sivandi	siy
Siwa	siz
Epena Saija	sja
Kildin Sami	sjd
Miji	sjl
Jama Mapun	sjm
Sindarin (Artificial)	sjn
Siar-Lak	sjr
Shawnee	sjw
Saek	skb
Sakalava	skg
Sikka	ski
Siraiki Hindki	skr
Siraiki Sindhi	skr
Siraiki	skr
Sakata	skt
Sakau	sku
Skou	skv
Sissala	sld
Soliga	sle
Slovak	slk
Yui	sll
Pangutaran Sama	slm
Salinan	sln
Lamaholot	slp
Lewoingu dialect	slp
Salar	slr
Slovenian	slv
Salampasu	slx
Ma'ya (Indonesia)	slz
Southern Sami	sma
Northern Sami	sme
Lule Sami	smj
Bolinao	smk
Central Sama	sml
Inari Sami	smn
Samoan	smo
Samaritan Hebrew	smp
Samo	smq
Simeulue	smr
Skolt Sami	sms
Simte	smt
Sumbawa	smw
Zezuru	sna
Shona	sna
Korekore	sna
Sinagoro	snc
Sindhi	snd
Bau-Jagoi	sne
Noon	snf
Sanga	sng
Soninke	snk
Sangil	snl
Sioni	snn
Snohomish	sno
Lambau	snp
Siane	snp
Komunku	snp
Sangu (Gabon)	snq
Sobei	sob
Sogdian	sog
Somali	som
Songye	sop
Sembla	sos
Sotho	sot
Southern Thai	sou
Spanish	spa
Selepet	spl
Spokane	spo
Suppire	spp
Saposa	sps
Sapuan	spu
Sabaot	spy
Albanian	sqi
Susquehanna	sqn
Sokotri	sqt
Squawmish	squ
Suquamish	squ
Sora	srb
Sardinian	srd
Sara	sre
Sulod	srg
Sarikoli	srh
Siriano	sri
Saberi	srl
Saramaccan	srm
Sranan	srn
Serbian	srp
Stokavian	srp
Serer	srr
Sarsi	srs
Sirmauri	srx
Sama Sibutu	ssb
Siroi	ssd
Balangingì	sse
Thao	ssf
Sissano	sso
Spanish Sign	ssp
Swazi	ssw
Saho	ssy
Lummi	str
Saanich	str
North Straits Salish	str
Silte	stv
Sulka	sua
Suku (Congo)	sub
Western Subanon	suc
Suena	sue
Suba	suh
Sukuma	suk
Tawahka (Honduras)	sum
Sumo	sum
Ulva	sum
Sundanese	sun
Cirebon	sun
Mupun	sur
Mwaghavul	sur
Susu	sus
Sulung	suv
Sumerian	sux
Sunwar	suz
Svan	sva
Lashkh	sva
Shimaore	swb
Kingwana	swc
Swedish	swe
Mwini dialect	swh
Cifundi	swh
Swahili	swh
Sui	swi
Sira	swj
Swedish Sign	swl
Suau	swp
Saweru	swr
Suwawa	swu
Bune Bonda	swu
Shekhawati	swv
Sangir (Indonesia and Philippines)	sxn
Central Subanen	syb
Sylheti	syl
Syriac	syr
Kagate	syw
Semelai	sza
Sawai	szw
Tabasaran	tab
Tariana	tae
Tapirapé	taf
Tagoi	tag
Tahitian	tah
Tamil	tam
Tangale	tan
Yami	tao
Tabwa	tap
Kitabwa	tap
Mishar	tat
Tatar	tat
Upper Tanana	tau
Pamoa	tav
Atayal	tay
Kaki Ae	tbd
Dharawal	tbh
Ingassana	tbi
Kalamian	tbk
Tboli	tbl
Tavara (Papua New Guinea)	tbo
"Tembo (Sud-Kivu, Congo)"	tbt
Tagbanua	tbw
Somba	tbz
Tucuna	tca
Tanacross	tcb
Southern Tutchone	tce
Toda (India)	tcx
Tulu	tcy
Kuki	tcz
Thado	tcz
Tai Nüa	tdd
Thulung	tdh
Tondano	tdn
Temiar	tea
Tepo	ted
Teke	teg
Tzoneca	teh
Konda?Reddi dialect	tel
Telugu	tel
Temne	tem
Teso	teo
Terena	ter
Tengger	tes
Tetum	tet
So (Uganda)	teu
Tewa	tew
Dena'ina	tfn
Terraba	tfr
Ternate	tft
Tigak	tgc
Tanga (Tanga Islands)	tgg
Tajik	tgk
Tagalog	tgl
Tagula	tgo
Tagbana	tgw
Tagish	tgx
Thai	tha
Thayore	thd
Tharaka	thk
Ntlakyapamuk	thp
Thakali	ths
Tifal	tif
Tigré	tig
Tikar	tik
Tillamook	til
Timbe	tim
Tindi	tin
Teop	tio
Tiéfo	tiq
Tigrinya	tir
Tiv	tiv
Tiwi (Australia)	tiw
Isleta	tix
Tiruray	tiy
Timucua	tjm
Tokelauan	tkl
Takelma	tkm
Tikopia	tkp
Tsakhur	tkr
Tobelo	tlb
Talaud	tld
Nenusa-Miangas	tld
Telefol	tlf
Klingon (Artificial)	tlh
Tlingit	tli
Talinga-Bwisi	tlj
Tetela	tll
Talise	tlr
Sobojo	tlv
Talysh	tly
Avava	tmb
Tumak	tmc
Tamajaq	tmh
Taman language (Indonesia)	tmn
Tumleo	tmq
Tami	tmy
Tacana (Bolivia)	tna
Lenakel	tnl
Tabla	tnm
Tepera	tnm
Taino	tnq
Bedik	tnr
Tontemboan	tnt
Toba (Indian)	tob
Toma	tod
Tonga (Nyasa)	tog
Tonga (Inhambane)	toh
Tojolabal	toj
Tombulu	tom
Tongan	ton
Toposa	toq
Tho	tou
Jemez	tow
Tok Pisin	tpi
Tampulma	tpm
Tupi	tpw
Trumai	tpy
Tinputz	tpz
Tenetehara	tqb
Toaripi	tqo
Tunni	tqq
Tonkawa	tqw
Trio	tri
Kok Borok	trp
Sedik	trv
Torwali	trw
Tsamai	tsb
Tswa	tsc
Tsakonian	tsd
Sulu	tsg
Tausug	tsg
Tsimshian	tsi
Memba	tsj
Tswana	tsn
Tsonga	tso
Thai Sign Language	tsq
Akei	tsr
Tsou	tsu
Tsogo	tsv
Tarascan	tsz
Tutelo	tta
Tectiteco	ttc
Tubetube	tte
Tooro	ttj
Tera	ttr
Tat	ttt
Tubatulabal	tub
Tuyuca	tue
Tupuri	tui
Turkmen	tuk
Tumbuka	tum
Tunica	tun
Tucano	tuo
Teda	tuq
Turkish	tur
Tuscarora	tus
Turkana	tuv
Tugen	tuy
Tuvaluan	tvl
Tidore	tvo
Taveta	tvs
Tutsa	tvt
White Tai	twh
Twi	twi
Tawoyan	twy
Tombonuwo	txa
Tolitoli	txe
Tangut	txg
Thracian	txh
Tonsea	txs
Cayapo	txu
Tatana'	txx
Tauya	tya
Kombai	tyn
Tuvinian	tyv
Ubir	ubr
Gawigl	ubu
Ubykh	uby
Udekhe	ude
Udi	udi
Uldeme	udl
Udmurt	udm
Uduk	udu
Ugaritic	uga
Uighur	uig
Ukrainian	ukr
Olcha	ulc
Umbundu	umb
Umotina	umo
Umpila	ump
Munsee	umu
Ngarinyin	ung
Worora	unp
Bhumij	unr
Unde Kaili	unz
Atchin	upv
Uripiv	upv
Urarina	ura
Urubu	urb
Urubu Kaapor	urb
Urdu	urd
Uru	ure
Urhobo	urh
Urim	uri
Urak Lawoi'	urk
Urali	url
Orya	ury
Usarufa	usa
Uspanteca	usp
Chemehuevi	ute
Southern Paiute	ute
Ute	ute
Greek Tatar	uum
Pazeh	uun
Ura (Vanuatu)	uur
Urii	uvh
Lote	uvl
Uzbek	uzb
Sart	uzn
Vaagri Boli	vaa
Vagala	vag
Varhadi-Nagpuri	vah
Vai	vai
Valman	van
Vaiphei	vap
Guarijío	var
Dehawali	vas
Hayu	vay
Vayu	vay
Veddah (Sinhalese)	ved
Venda	ven
Veps	vep
Vietnamese	vie
Vili	vif
Vige	vig
Vilela	vil
Lule	vil
Iduna	viv
Martuyhunira	vma
Votic	vot
Venezuelan Sign	vsl
Vute	vut
Tlakluit	wac
Wasco	wac
Wandamen	wad
Walser	wae
Waffa	waj
Walamo	wal
Massachuset	wam
Wampanoag	wam
Wappo	wao
Wageman	waq
Washo	was
Waiwai	waw
Wayana	way
Warao	wba
Mwamba	wbh
Waigali	wbk
Wakhi	wbl
Wa	wbm
Warlpiri	wbp
Wagdi	wbr
Watjari	wbv
Wedau	wed
Wewewa	wew
Wangganguru	wgg
Wahgi	wgi
Wichita	wic
Wik-Mungkan	wim
Winnebago	win
Wintu	wit
Wiru	wiu
Wirangu	wiw
Wiyot	wiy
Waja	wja
Wakawaka	wkw
Duungidjawu	wkw
Walloon	wln
Wolio	wlo
East Uvean	wls
Vejoz	wlv
Wambule	wme
Waima'a	wmh
Wambon	wms
Walmatjari	wmt
Wantoat	wnc
Wandarang	wnd
Wanetsi	wne
Usan	wnu
Wobe	wob
Woleai	woe
Woisika	woi
Wolof	wol
Lebou	wol
Manui	wow
Warapu	wra
Wiradjuri	wrh
Wariyangga	wri
Warumungu	wrm
Waropen	wrp
Wardaman	wrr
Waris	wrs
Waray	wrz
Warembori	wsa
Waskia	wsk
Wotapuri-Katarqalai	wsv
Berta	wti
Mewati	wtm
Wotu	wtw
Wutun	wuh
Wuvulu	wuv
Waama	wwa
Warrwa	wwr
Wyandot	wya
Wongaibon	wyb
Kalmyk	xal
Oirat	xal
Torgut	xal
Kham	xam
Apalachee	xap
Kamassin	xas
Xavante	xav
Kawaiisu	xaw
Kambera	xbr
Celtiberian	xce
"Armenian, Classical"	xcl
Carian	xcr
Coahuilteco	xcw
Dacian	xdc
Lamandau	xdy
Eblaite	xeb
Hedi	xed
Faliscan	xfa
Khetrani	xhe
Xhosa	xho
Hattic	xht
Hurrian	xhu
Iberian	xib
Xinca	xin
Mendalam Kayan	xkd
Kgalagadi	xkv
Ngologa	xkv
Kamula	xla
Lycian	xlc
Lydian	xld
Median	xme
Mingrelian	xmf
Meroitic	xmr
Tsimihety	xmw
Northern Kankanay	xnn
Anglo-Norman	xno
Kangri	xnr
Soga	xog
Konkomba	xon
Phrygian	xpg
Parthian	xpr
Punic	xpu
Kraho	xra
Raetian	xrr
Sabaean	xsa
Tina Sambal	xsb
Sio	xsi
Kasem	xsm
Nunuma	xsm
Sherpa	xsr
Saisiyat	xsy
Ketengban	xte
Alu-Kurumba	xua
Umbrian	xum
Kuo	xuo
Urartian	xur
Khoikhoi	xuu
Venetic	xve
Vandal	xvn
Woccon	xwc
Zhangzhung	xzh
Jaminaua	yaa
Yagua	yad
Yaruro	yae
Yaka (Congo and Angola)	yaf
Yahgan	yag
Yazghulami	yah
Yaghnobi	yai
Yakama	yak
Yalunka	yal
Yamba (Cameroon and Nigeria)	yam
Yao (Africa)	yao
Yapese	yap
Yaqui	yaq
Gunu	yas
Yambeta	yat
Yakö	yaz
Yala	yba
Yemba	ybb
Yellow Uighur	ybe
Western Yugur	ybe
Yakha	ybh
Yamphu	ybi
Yabiyufa	yby
Yucuna	ycn
Yerava	yea
Yeniche	yec
Yimas	yee
Tarok	yer
Yerukala	yeu
Yeyi	yey
Hua (Papua New Guinea)	ygr
Yagaria	ygr
Yinggarda	yia
Yiddish	yid
Yidiny	yii
Jindjibandji	yij
Yimchungru	yim
Yir-Yoront	yiy
Yakan	yka
Yasa	yko
Yakoma	yky
Yele	yle
Nyalayu	yly
Iamalele	yml
Maay	ymm
Mysian	yms
Yana	ynn
Yahi	ynn
Yanzi	yns
Tanimuca-Retuama	ynu
Yogad	yog
Yokuts	yok
Yombe (Congo and Angola)	yom
Yongkom	yon
Ijebu	yor
Yoruba	yor
Yareba	yrb
Yaouré	yre
Nenets	yrk
Forest Nenets	yrk
Sirinek	ysr
Yessan-Mayo	yss
Yuchi	yuc
Havasupai	yuf
Hualapai	yuf
Yavapai	yuf
Yuruti	yui
Yuri	yuj
Yuki	yuk
Yulu	yul
Yupa	yup
Yurok	yur
Yopno	yut
Yugh	yuu
Eastern Yugur	yuy
Yuracare	yuz
Yawa	yva
Yau	yyu
Zaghawa	zag
Zanaki	zak
Zapotec	zap
Zenaga	zen
Kinga	zga
Zhuang	zha
Chinese	zho
Zigula	ziw
Khorezmian Turkic	zkh
Kott	zko
Zakhring	zkr
Khitan	zkt
Kaurna	zku
Deli	zlm
Pasir	zlm
Sambas	zlm
Margany	zmc
Mituku	zmq
Maranungku	zmr
Muruwari	zmu
Bomitaba	zmx
Zande	zne
Zou	zom
Papabuco	zpw
Zaparo	zro
Zulu	zul
Zuni	zun
Zway	zwa
Zaza	zza
