Afade language	aal	0	su:"Afade language"
Abo (Cameroon) language	abb	0	su:"Abo (Cameroon) language"
Tapanta language	abq	0	su:"Tapanta language"
Abron language	abr	0	su:"Abron language"
Ambonese Malay language	abs	0	su:"Ambonese Malay language"
Pailibo language	adi	0	su:"Pailibo language"
Wailpi language	adt	0	su:"Wailpi language"
Chemgui language	ady	0	su:"Chemgui language"
Senya language	afu	0	su:"Senya language"
Aguacatec language	agu	0	su:"Aguacatec language"
Ahirani language	ahr	0	su:"Ahirani language"
Aja (Sudan) language	aja	0	su:"Aja (Sudan) language"
Aja (Benin and Togo) language	ajg	0	su:"Aja (Benin and Togo) language"
Angkola language	akb	0	su:"Angkola language"
Anakalang language	akg	0	su:"Anakalang language"
Amarag language	amg	0	su:"Amarag language"
Ama (Papua New Guinea) language	amm	0	su:"Ama (Papua New Guinea) language"
Ami language (Australia)	amy	0	su:"Ami language (Australia)"
Sanwi language	any	0	su:"Sanwi language"
Arecuna language	aoc	0	su:"Arecuna language"
Camaracoto language	aoc	0	su:"Camaracoto language"
Taurepan language	aoc	0	su:"Taurepan language"
Magi (Southern Highlands Province, Papua New Guinea) language	aoe	0	su:"Magi (Southern Highlands Province, Papua New Guinea) language"
Andilyaugwa language	aoi	0	su:"Andilyaugwa language"
White Mountain Apache language	apw	0	su:"White Mountain Apache language"
Wojokeso language	apz	0	su:"Wojokeso language"
Cheso language	arg	0	su:"Cheso language"
Moluche language	arn	0	su:"Moluche language"
Karo (Brazil) language	arr	0	su:"Karo (Brazil) language"
Assiniboine language	asb	0	su:"Assiniboine language"
Australian Sign Language language	asf	0	su:"Australian Sign Language language"
Bable language	ast	0	su:"Bable language"
Teleut language	atv	0	su:"Teleut language"
Awa (Eastern Highlands Province, Papua New Guinea) language	awb	0	su:"Awa (Eastern Highlands Province, Papua New Guinea) language"
Aka (Central African Republic) language	axk	0	su:"Aka (Central African Republic) language"
Armenian, Middle language	axm	0	su:"Armenian, Middle language"
Moro (South America) language	ayo	0	su:"Moro (South America) language"
Afshar language	azb	0	su:"Afshar language"
Kuvakan language	bak	0	su:"Kuvakan language"
Bai (China) language	bca	0	su:"Bai (China) language"
Kohumono language	bcs	0	su:"Kohumono language"
Bakundu language	bdu	0	su:"Bakundu language"
Bankudu-Balue language	bdu	0	su:"Bankudu-Balue language"
Yugambeh?Bundjalung dialects	bdy	0	su:"Yugambeh?Bundjalung dialects"
Yugumbeh language	bdy	0	su:"Yugumbeh language"
Bembe (Congo (Brazzaville)) language	beq	0	su:"Bembe (Congo (Brazzaville)) language"
Betawi language	bew	0	su:"Betawi language"
Kuku language	bfa	0	su:"Kuku language"
Badaga language	bfq	0	su:"Badaga language"
Marari language	bfy	0	su:"Marari language"
Bangaru language	bgc	0	su:"Bangaru language"
Deswali language	bgc	0	su:"Deswali language"
Rathvi dialect	bgd	0	su:"Rathvi dialect"
Bagri language	bgq	0	su:"Bagri language"
Bhalesi language	bhd	0	su:"Bhalesi language"
Bhadrawahi language	bhd	0	su:"Bhadrawahi language"
Bahing language	bhj	0	su:"Bahing language"
Kolo language	bhp	0	su:"Kolo language"
Bara (Madagascar) language	bhr	0	su:"Bara (Madagascar) language"
Bada (Indonesia) language	bhz	0	su:"Bada (Indonesia) language"
Birhor language	biy	0	su:"Birhor language"
Kanauji language	bjj	0	su:"Kanauji language"
Antaisaka language	bjq	0	su:"Antaisaka language"
Southern Bontoc language	bkb	0	su:"Southern Bontoc language"
Eastern Bontoc language	bkb	0	su:"Eastern Bontoc language"
Baka (Cameroon and Gabon) language	bkc	0	su:"Baka (Cameroon and Gabon) language"
Brokpa language	bkk	0	su:"Brokpa language"
Kom (Cameroon) language	bkm	0	su:"Kom (Cameroon) language"
Uki language	bld	0	su:"Uki language"
Ayta Mag Indi language	blx	0	su:"Ayta Mag Indi language"
Bembe (Lake Tanganyika) language	bmb	0	su:"Bembe (Lake Tanganyika) language"
Boomu language	bmq	0	su:"Boomu language"
Burum (Papua New Guinea) language	bmu	0	su:"Burum (Papua New Guinea) language"
Banda (Indonesia) language	bnd	0	su:"Banda (Indonesia) language"
Pawari language	bns	0	su:"Pawari language"
Boni (Kenya and Somalia) language	bob	0	su:"Boni (Kenya and Somalia) language"
Boma (Congo) language	boh	0	su:"Boma (Congo) language"
Bororo (Brazil) language	bor	0	su:"Bororo (Brazil) language"
Bishnupuriya language	bpy	0	su:"Bishnupuriya language"
Mkaa' language	bqz	0	su:"Mkaa' language"
Werchikwar language	bsk	0	su:"Werchikwar language"
Taiwano language	bsn	0	su:"Taiwano language"
Bassa (Liberia and Sierra Leone) language	bsq	0	su:"Bassa (Liberia and Sierra Leone) language"
Bakossi language	bss	0	su:"Bakossi language"
Basketo language	bst	0	su:"Basketo language"
Dairi Pakpak language	btd	0	su:"Dairi Pakpak language"
Biatah language	bth	0	su:"Biatah language"
Simelungun language	bts	0	su:"Simelungun language"
Meratus language	bvu	0	su:"Meratus language"
Balong language	bwt	0	su:"Balong language"
Bor (Lwo) language	bxb	0	su:"Bor (Lwo) language"
Batak (Philippines) language	bya	0	su:"Batak (Philippines) language"
Bribri language	bzd	0	su:"Bribri language"
Biri (Australia) language	bzr	0	su:"Biri (Australia) language"
Canichana language	caz	0	su:"Canichana language"
Carapana (Tucanoan) language	cbc	0	su:"Carapana (Tucanoan) language"
Laizo (Burma) language	cfm	0	su:"Laizo (Burma) language"
Akka language	che	0	su:"Akka language"
Ozumacín language	chz	0	su:"Ozumacin language"
Amikwa language	ciw	0	su:"Amikwa language"
Khumi Awa language	cka	0	su:"Khumi Awa language"
Mukri language	ckb	0	su:"Mukri language"
Anufo language	cko	0	su:"Anufo language"
Maa (Vietnam) language	cma	0	su:"Maa (Vietnam) language"
Maa (Southeastern Asia) language	cma	0	su:"Maa (Southeastern Asia) language"
Biat language	cmo	0	su:"Biat language"
Central Mnong language	cmo	0	su:"Central Mnong language"
Ahraing Khumi language	cnk	0	su:"Ahraing Khumi language"
Bohairic language	cop	0	su:"Bohairic language"
Chilean Sign Language language	csg	0	su:"Chilean Sign Language language"
Esuulaalu language	csk	0	su:"Esuulaalu language"
Costa Rican Sign Language language	csr	0	su:"Costa Rican Sign Language language"
Tiddim Chin language	ctd	0	su:"Tiddim Chin language"
Sicuane language	cui	0	su:"Sicuane language"
Zotung language	czt	0	su:"Zotung language"
Day (Chad) language	dai	0	su:"Day (Chad) language"
Santee language	dak	0	su:"Santee language"
Yankton language	dak	0	su:"Yankton language"
Kubachi language	dar	0	su:"Kubachi language"
Dabida language	dav	0	su:"Dabida language"
Begak language	dbj	0	su:"Begak language"
Dendi language	ddn	0	su:"Dendi language"
Chutiya language	der	0	su:"Chutiya language"
Dumagat (Casiguran) language	dgc	0	su:"Dumagat (Casiguran) language"
Wule language	dgi	0	su:"Wule language"
Jaipuri language	dhd	0	su:"Jaipuri language"
Himba language	dhm	0	su:"Himba language"
Dhodia language	dho	0	su:"Dhodia language"
Dargari language	dhr	0	su:"Dargari language"
Boni (French Guiana and Suriname) language	djk	0	su:"Boni (French Guiana and Suriname) language"
Bor (Dinka) language	dks	0	su:"Bor (Dinka) language"
Dalmatian (Romance) language	dlm	0	su:"Dalmatian (Romance) language"
Vegliote language	dlm	0	su:"Vegliote language"
Badakhshani language	drw	0	su:"Badakhshani language"
Danish Sign Language language	dsl	0	su:"Danish Sign Language language"
Dumagat (Umirey) language	due	0	su:"Dumagat (Umirey) language"
Dungra Bhil language	duh	0	su:"Dungra Bhil language"
Daza language	dzd	0	su:"Daza language"
Koniagmiut language	ems	0	su:"Koniagmiut language"
Chugach language	ems	0	su:"Chugach language"
Setu language	est	0	su:"Setu language"
Mulgi language	est	0	su:"Mulgi language"
Karksi language	est	0	su:"Karksi language"
Aglemiut language	esu	0	su:"Aglemiut language"
Solon language	evn	0	su:"Solon language"
Annobon language	fab	0	su:"Annobon language"
Kifuliru language	flr	0	su:"Kifuliru language"
Cajun French language	frc	0	su:"Cajun French language"
Vaudois language	frp	0	su:"Vaudois language"
Bororo (West Africa) language	fuv	0	su:"Bororo (West Africa) language"
Adiwasi Garasia language	gas	0	su:"Adiwasi Garasia language"
Gadaba (Dravidian) language	gau	0	su:"Gadaba (Dravidian) language"
Boran language	gax	0	su:"Boran language"
Gadaba (Munda) language	gbj	0	su:"Gadaba (Munda) language"
Gadi language	gbk	0	su:"Gadi language"
Gamit language	gbl	0	su:"Gamit language"
Parvati language	gbm	0	su:"Parvati language"
Yaghwatadaxa language	gdf	0	su:"Yaghwatadaxa language"
Gen-Gbe language	gej	0	su:"Gen-Gbe language"
Chitapavani language	gom	0	su:"Chitapavani language"
Kudali language	gom	0	su:"Kudali language"
Tilamuta language	gor	0	su:"Tilamuta language"
Parsi-Gujarati language	guj	0	su:"Parsi-Gujarati language"
Sea Islands Creole language	gul	0	su:"Sea Islands Creole language"
Marigl language	gvf	0	su:"Marigl language"
Gwa (Ghana) language	gwx	0	su:"Gwa (Ghana) language"
Yaayuwee language	gya	0	su:"Yaayuwee language"
Qottu language	hae	0	su:"Qottu language"
Hanga (Ghana) language	hag	0	su:"Hanga (Ghana) language"
Uwana language	hau	0	su:"Uwana language"
Black Hmong language	hea	0	su:"Black Hmong language"
Hua Hmong language	hmd	0	su:"Hua Hmong language"
Kapau language	hmt	0	su:"Kapau language"
Chattisgarhi language	hne	0	su:"Chattisgarhi language"
Hmong Njua language	hnj	0	su:"Hmong Njua language"
Cakavian language	hrv	0	su:"Cakavian language"
Székely language	hun	0	su:"Szekely language"
Chilliwack language	hur	0	su:"Chilliwack language"
Armenian, Modern language	hye	0	su:"Armenian, Modern language"
Iwaidji language	ibd	0	su:"Iwaidji language"
Ngwa language	ibo	0	su:"Ngwa language"
Ibani language	iby	0	su:"Ibani language"
Icelandic Sign Language language	icl	0	su:"Icelandic Sign Language language"
Idakho-Isukha-Tiriki language	ida	0	su:"Idakho-Isukha-Tiriki language"
Amganad Ifugao language	ifa	0	su:"Amganad Ifugao language"
Batad Ifugao language	ifb	0	su:"Batad Ifugao language"
Ayangan Ifugao language	ifb	0	su:"Ayangan Ifugao language"
Tuwali language	ifk	0	su:"Tuwali language"
Kiangan Ifugao language	ifk	0	su:"Kiangan Ifugao language"
Mayoyao Ifugao language	ifu	0	su:"Mayoyao Ifugao language"
Kolokuma language	ijc	0	su:"Kolokuma language"
Kalabari language	ijn	0	su:"Kalabari language"
Inuvialuktun language	ikt	0	su:"Inuvialuktun language"
Occidental (Artificial) language	ile	0	su:"Occidental (Artificial) language"
Inor language	ior	0	su:"Inor language"
Münkü language	irn	0	su:"Munku language"
Kasaba language	iru	0	su:"Kasaba language"
Itzá language	itz	0	su:"Itza language"
Yao (Southeastern Asia) language	ium	0	su:"Yao (Southeastern Asia) language"
Itbayat language	ivb	0	su:"Itbayat language"
Jah Hut language	jah	0	su:"Jah Hut language"
Banten language	jav	0	su:"Banten language"
Tegal language	jav	0	su:"Tegal language"
Ngomba (Bamileke) language	jgo	0	su:"Ngomba (Bamileke) language"
Jaunsari language	jns	0	su:"Jaunsari language"
Kara (Central African Republic and Sudan) language	kah	0	su:"Kara (Central African Republic and Sudan) language"
Kaje language	kaj	0	su:"Kaje language"
Ammassalimiut language	kal	0	su:"Ammassalimiut language"
Jenukuruba language	kan	0	su:"Jenukuruba language"
Adzhar language	kat	0	su:"Adzhar language"
Gurian language	kat	0	su:"Gurian language"
Imeretian language	kat	0	su:"Imeretian language"
Ingilo language	kat	0	su:"Ingilo language"
Kaiwa (Papua New Guinea) language	kbm	0	su:"Kaiwa (Papua New Guinea) language"
Southern Khanty language	kca	0	su:"Southern Khanty language"
Kagoro (Nigeria) language	kcg	0	su:"Kagoro (Nigeria) language"
Lilima language	kck	0	su:"Lilima language"
Kalanga (Botswana and Zimbabwe) language	kck	0	su:"Kalanga (Botswana and Zimbabwe) language"
Kui (Mon-Khmer) language	kdt	0	su:"Kui (Mon-Khmer) language"
Cape Verde Creole language	kea	0	su:"Cape Verde Creole language"
Kakwa language	keo	0	su:"Kakwa language"
Kota (India) language	kfe	0	su:"Kota (India) language"
Kachchhi language	kfr	0	su:"Kachchhi language"
Bilaspuri language	kfs	0	su:"Bilaspuri language"
Komering language	kge	0	su:"Komering language"
Nirere language	kib	0	su:"Nirere language"
Northeastern Kiwai language	kiw	0	su:"Northeastern Kiwai language"
Guguyimidjir language	kky	0	su:"Guguyimidjir language"
Sotang Kura language	kle	0	su:"Sotang Kura language"
Kipsikis language	kln	0	su:"Kipsikis language"
Kom (India) language	kmm	0	su:"Kom (India) language"
Karipuna Creole language	kmv	0	su:"Karipuna Creole language"
Komo (Congo) language	kmw	0	su:"Komo (Congo) language"
Koongo (Western Kongo) language	kng	0	su:"Koongo (Western Kongo) language"
Agri language	knn	0	su:"Agri language"
Kunabi language	knn	0	su:"Kunabi language"
Srê language	kpm	0	su:"Sre language"
Komi-Yaz'va language	kpv	0	su:"Komi-Yaz'va language"
Palan language	kpy	0	su:"Palan language"
Kumali language	kra	0	su:"Kumali language"
Uare language	ksj	0	su:"Uare language"
Qebena dialect	ktb	0	su:"Qebena dialect"
Hazili language	kup	0	su:"Hazili language"
Akit language	kvr	0	su:"Akit language"
Kurmali language	kyw	0	su:"Kurmali language"
Dongola-Kenuz language	kzh	0	su:"Dongola-Kenuz language"
Karang (Cameroon) language	kzr	0	su:"Karang (Cameroon) language"
Southern Subanen language	laa	0	su:"Southern Subanen language"
Chamba Lahuli language	lae	0	su:"Chamba Lahuli language"
Pattani (India) language	lae	0	su:"Pattani (India) language"
Lamba (Zambia and Congo) language	lam	0	su:"Lamba (Zambia and Congo) language"
Pasir (Lawangan) language	lbx	0	su:"Pasir (Lawangan) language"
Bawo (Indonesia) language	lbx	0	su:"Bawo (Indonesia) language"
Laadi language	ldi	0	su:"Laadi language"
Ambo (Zambia) language	leb	0	su:"Ambo (Zambia) language"
Kara (Papua New Guinea) language	leu	0	su:"Kara (Papua New Guinea) language"
Limburgish language	lim	0	su:"Limburgish language"
Hua Lisu language	lis	0	su:"Hua Lisu language"
Lembak Bilide language	liw	0	su:"Lembak Bilide language"
Laha (Vietnam) language	lkh	0	su:"Laha (Vietnam) language"
Ladin language	lld	0	su:"Ladin language"
Lele (Chad) language	lln	0	su:"Lele (Chad) language"
Lamé (Cameroon) language	lme	0	su:"Lame (Cameroon) language"
Guyuk language	lnu	0	su:"Guyuk language"
Ekonda language	lol	0	su:"Ekonda language"
Téén language	lor	0	su:"Teen language"
Lopa (Nepal) language	loy	0	su:"Lopa (Nepal) language"
Ludic language	lud	0	su:"Ludic language"
Luo (Kenya and Tanzania) language	luo	0	su:"Luo (Kenya and Tanzania) language"
Lumbu (Gabon) language	lup	0	su:"Lumbu (Gabon) language"
Hanga (Kenya) language	luy	0	su:"Hanga (Kenya) language"
Kisa language	luy	0	su:"Kisa language"
Maku'a (Indonesia) language	lva	0	su:"Maku'a (Indonesia) language"
Lwo (Sudan) language	lwo	0	su:"Lwo (Sudan) language"
Khotta language	mai	0	su:"Khotta language"
Moplah language	mal	0	su:"Moplah language"
Koshti (Marathi) language	mar	0	su:"Koshti (Marathi) language"
Higaonon language	mba	0	su:"Higaonon language"
Mbo (Cameroon) language	mbo	0	su:"Mbo (Cameroon) language"
Mbunda (Angola and Zambia) language	mck	0	su:"Mbunda (Angola and Zambia) language"
Maka (Cameroon) language	mcp	0	su:"Maka (Cameroon) language"
Moksha language	mdf	0	su:"Moksha language"
Mbala (Bandundu, Congo) language	mdp	0	su:"Mbala (Bandundu, Congo) language"
Male (Ethiopia) language	mdy	0	su:"Male (Ethiopia) language"
Mara (Australia) language	mec	0	su:"Mara (Australia) language"
Pattani (Thailand) language	mfa	0	su:"Pattani (Thailand) language"
Malgwa language	mfi	0	su:"Malgwa language"
Mayo (Piman) language	mfy	0	su:"Mayo (Piman) language"
Ma'di (Uganda and Sudan) language	mhi	0	su:"Ma'di (Uganda and Sudan) language"
Miami (Ind. and Okla.) language	mia	0	su:"Miami (Ind. and Okla.) language"
Mandeali language	mjl	0	su:"Mandeali language"
Taimoro language	mlg	0	su:"Taimoro language"
Mawasangka language	mnb	0	su:"Mawasangka language"
Mono (Congo) language	mnh	0	su:"Mono (Congo) language"
Moro (Sudan) language	mor	0	su:"Moro (Sudan) language"
Yana (Burkina Faso and Togo) language	mos	0	su:"Yana (Burkina Faso and Togo) language"
Motilon language	mot	0	su:"Motilon language"
Mullukmulluk language	mpb	0	su:"Mullukmulluk language"
Mandjildjara language	mpj	0	su:"Mandjildjara language"
Mbara (Chad) language	mpk	0	su:"Mbara (Chad) language"
Mbuko language	mqb	0	su:"Mbuko language"
Mbelime language	mql	0	su:"Mbelime language"
Manggarai (Indonesia) language	mqy	0	su:"Manggarai (Indonesia) language"
Abujhmaria language	mrr	0	su:"Abujhmaria language"
Madiya-Gondi language	mrr	0	su:"Madiya-Gondi language"
Lanao Moro language	mrw	0	su:"Lanao Moro language"
Musei language	mse	0	su:"Musei language"
Masikoro language	msh	0	su:"Masikoro language"
Mewari language	mtr	0	su:"Mewari language"
Vulum language	mug	0	su:"Vulum language"
Mpus language	mug	0	su:"Mpus language"
Mundu (Sudan and Congo) language	muh	0	su:"Mundu (Sudan and Congo) language"
Musi language	mui	0	su:"Musi language"
Malvi language	mup	0	su:"Malvi language"
Muduva language	muv	0	su:"Muduva language"
Ordos language	mvf	0	su:"Ordos language"
Mesqan language	mvz	0	su:"Mesqan language"
Mirandese language	mwl	0	su:"Mirandese language"
Majingai language	mwm	0	su:"Majingai language"
Mabuiag language	mwp	0	su:"Mabuiag language"
Miju language	mxj	0	su:"Miju language"
Maxi language	mxl	0	su:"Maxi language"
Mada (Cameroon) language	mxu	0	su:"Mada (Cameroon) language"
Mau language	mxx	0	su:"Mau language"
Mbai (Moissala) language	myb	0	su:"Mbai (Moissala) language"
Mura language	myp	0	su:"Mura language"
Mo (Côte d'Ivoire and Ghana) language	mzw	0	su:"Mo (Cote d'Ivoire and Ghana) language"
Kongara language	nas	0	su:"Kongara language"
Rongmei language	nbu	0	su:"Rongmei language"
Wangkumara (Galali) language	nbx	0	su:"Wangkumara (Galali) language"
Ndebele (Zimbabwe) language	nde	0	su:"Ndebele (Zimbabwe) language"
Pahri language	new	0	su:"Pahri language"
Dolakha language	new	0	su:"Dolakha language"
Doko (Congo) language	ngc	0	su:"Doko (Congo) language"
Ngemba (Cameroon) language	nge	0	su:"Ngemba (Cameroon) language"
Mankon language	nge	0	su:"Mankon language"
Khomani language	ngh	0	su:"Khomani language"
Chiripá language	nhd	0	su:"Chiripa language"
Ngadju (Australia) language	nju	0	su:"Ngadju (Australia) language"
Nkunya language	nko	0	su:"Nkunya language"
Ngama language	nmc	0	su:"Ngama language"
Ukhrul language	nmf	0	su:"Ukhrul language"
Norwegian (Nynorsk) language	nno	0	su:"Norwegian (Nynorsk) language"
Nimadi language	noe	0	su:"Nimadi language"
Baria language	nrb	0	su:"Baria language"
Chakhesang language	nri	0	su:"Chakhesang language"
Norn language	nrn	0	su:"Norn language"
Gananwa language	nso	0	su:"Gananwa language"
Lobedu language	nso	0	su:"Lobedu language"
Moklum language	nst	0	su:"Moklum language"
Lungchang language	nst	0	su:"Lungchang language"
Yogli language	nst	0	su:"Yogli language"
Ngaanyatjara language	ntj	0	su:"Ngaanyatjara language"
Nguôn language	nuo	0	su:"Nguon language"
Chewa language	nya	0	su:"Chewa language"
Béarnais language	oci	0	su:"Bearnais language"
Japanese--Heian period, 794-1185 language	ojp	0	su:"Japanese--Heian period, 794-1185 language"
Korean--Middle Korean, 935-1500 language	okm	0	su:"Korean--Middle Korean, 935-1500 language"
Korean--To 935 language	oko	0	su:"Korean--To 935 language"
Okrika language	okr	0	su:"Okrika language"
Olonets language	olo	0	su:"Olonets language"
Tohono O'Odham language	ood	0	su:"Tohono O'Odham language"
Koozime language	ozm	0	su:"Koozime language"
Parintintin language	pah	0	su:"Parintintin language"
Pothwari language	phr	0	su:"Pothwari language"
Betsileo language	plt	0	su:"Betsileo language"
Pelende language	ppp	0	su:"Pelende language"
Madaglashti language	prs	0	su:"Madaglashti language"
Semendo language	pse	0	su:"Semendo language"
Besemah language	pse	0	su:"Besemah language"
Enim language	pse	0	su:"Enim language"
Lintang language	pse	0	su:"Lintang language"
Powari language	pwr	0	su:"Powari language"
Western Meohang language	raf	0	su:"Western Meohang language"
Rangdania language	rah	0	su:"Rangdania language"
Ramoaaina language	rai	0	su:"Ramoaaina language"
Rejang (Sumatra, Indonesia) language	rej	0	su:"Rejang (Sumatra, Indonesia) language"
Ritarungo language	rit	0	su:"Ritarungo language"
Caló (Romani) language	rmr	0	su:"Calo (Romani) language"
Lovari language	rmy	0	su:"Lovari language"
Roro (New Guinea) language	rro	0	su:"Roro (New Guinea) language"
Istro-Romanian language	ruo	0	su:"Istro-Romanian language"
Sango (Ubangi Creole) language	sag	0	su:"Sango (Ubangi Creole) language"
Saurashtri language	saz	0	su:"Saurashtri language"
Botolan Sambal language	sbl	0	su:"Botolan Sambal language"
Sangu (Tanzania) language	sbp	0	su:"Sangu (Tanzania) language"
Tyembara language	sef	0	su:"Tyembara language"
Koyraboro Senni language	ses	0	su:"Koyraboro Senni language"
Ayta Anchi Sambal language	sgb	0	su:"Ayta Anchi Sambal language"
Bartang language	sgh	0	su:"Bartang language"
Khuf language	sgh	0	su:"Khuf language"
Ishkashmi language	sgl	0	su:"Ishkashmi language"
Zebaki language	sgl	0	su:"Zebaki language"
Mende (Papua New Guinea) language	sim	0	su:"Mende (Papua New Guinea) language"
Kildin Sami language	sjd	0	su:"Kildin Sami language"
Sakalava language	skg	0	su:"Sakalava language"
Siraiki Hindki language	skr	0	su:"Siraiki Hindki language"
Siraiki Sindhi language	skr	0	su:"Siraiki Sindhi language"
Soliga language	sle	0	su:"Soliga language"
Ma'ya (Indonesia) language	slz	0	su:"Ma'ya (Indonesia) language"
Southern Sami language	sma	0	su:"Southern Sami language"
Northern Sami language	sme	0	su:"Northern Sami language"
Lule Sami language	smj	0	su:"Lule Sami language"
Bolinao language	smk	0	su:"Bolinao language"
Skolt Sami language	sms	0	su:"Skolt Sami language"
Zezuru language	sna	0	su:"Zezuru language"
Korekore language	sna	0	su:"Korekore language"
Bau-Jagoi language	sne	0	su:"Bau-Jagoi language"
Lambau language	snp	0	su:"Lambau language"
Komunku language	snp	0	su:"Komunku language"
Sangu (Gabon) language	snq	0	su:"Sangu (Gabon) language"
Sulod language	srg	0	su:"Sulod language"
Sarikoli language	srh	0	su:"Sarikoli language"
Stokavian language	srp	0	su:"Stokavian language"
Sirmauri language	srx	0	su:"Sirmauri language"
Balangingì language	sse	0	su:"Balangingi language"
Suku (Congo) language	sub	0	su:"Suku (Congo) language"
Western Subanon language	suc	0	su:"Western Subanon language"
Tawahka (Honduras) language	sum	0	su:"Tawahka (Honduras) language"
Ulva language	sum	0	su:"Ulva language"
Cirebon language	sun	0	su:"Cirebon language"
Mupun language	sur	0	su:"Mupun language"
Lashkh language	sva	0	su:"Lashkh language"
Shimaore language	swb	0	su:"Shimaore language"
Cifundi language	swh	0	su:"Cifundi language"
Bune Bonda language	swu	0	su:"Bune Bonda language"
Shekhawati language	swv	0	su:"Shekhawati language"
Sangir (Indonesia and Philippines) language	sxn	0	su:"Sangir (Indonesia and Philippines) language"
Central Subanen language	syb	0	su:"Central Subanen language"
Sylheti language	syl	0	su:"Sylheti language"
Kagate language	syw	0	su:"Kagate language"
Tavara (Papua New Guinea) language	tbo	0	su:"Tavara (Papua New Guinea) language"
Tembo (Sud-Kivu, Congo) language	tbt	0	su:"Tembo (Sud-Kivu, Congo) language"
Toda (India) language	tcx	0	su:"Toda (India) language"
Konda?Reddi dialect	tel	0	su:"Konda?Reddi dialect"
Tengger language	tes	0	su:"Tengger language"
So (Uganda) language	teu	0	su:"So (Uganda) language"
Tanga (Tanga Islands) language	tgg	0	su:"Tanga (Tanga Islands) language"
Tiwi (Australia) language	tiw	0	su:"Tiwi (Australia) language"
Nenusa-Miangas language	tld	0	su:"Nenusa-Miangas language"
Tami language	tmy	0	su:"Tami language"
Tacana (Bolivia) language	tna	0	su:"Tacana (Bolivia) language"
Toba (Indian) language	tob	0	su:"Toba (Indian) language"
Tonga (Nyasa) language	tog	0	su:"Tonga (Nyasa) language"
Tonga (Inhambane) language	toh	0	su:"Tonga (Inhambane) language"
Tsakonian language	tsd	0	su:"Tsakonian language"
Thai Sign Language language	tsq	0	su:"Thai Sign Language language"
Tugen language	tuy	0	su:"Tugen language"
Unde Kaili language	unz	0	su:"Unde Kaili language"
Ura (Vanuatu) language	uur	0	su:"Ura (Vanuatu) language"
Sart language	uzn	0	su:"Sart language"
Varhadi-Nagpuri language	vah	0	su:"Varhadi-Nagpuri language"
Dehawali language	vas	0	su:"Dehawali language"
Hayu language	vay	0	su:"Hayu language"
Vayu language	vay	0	su:"Vayu language"
Veddah (Sinhalese) language	ved	0	su:"Veddah (Sinhalese) language"
Walamo language	wal	0	su:"Walamo language"
Washo language	was	0	su:"Washo language"
Wagdi language	wbr	0	su:"Wagdi language"
Wewewa language	wew	0	su:"Wewewa language"
Wakawaka language	wkw	0	su:"Wakawaka language"
Walmatjari language	wmt	0	su:"Walmatjari language"
Wanetsi language	wne	0	su:"Wanetsi language"
Woleai language	woe	0	su:"Woleai language"
Lebou language	wol	0	su:"Lebou language"
Mewati language	wtm	0	su:"Mewati language"
Warrwa language	wwr	0	su:"Warrwa language"
Torgut language	xal	0	su:"Torgut language"
Armenian, Classical language	xcl	0	su:"Armenian, Classical language"
Khetrani language	xhe	0	su:"Khetrani language"
Mendalam Kayan language	xkd	0	su:"Mendalam Kayan language"
Ngologa language	xkv	0	su:"Ngologa language"
Tsimihety language	xmw	0	su:"Tsimihety language"
Kangri language	xnr	0	su:"Kangri language"
Tina Sambal language	xsb	0	su:"Tina Sambal language"
Nunuma language	xsm	0	su:"Nunuma language"
Yaka (Congo and Angola) language	yaf	0	su:"Yaka (Congo and Angola) language"
Yamba (Cameroon and Nigeria) language	yam	0	su:"Yamba (Cameroon and Nigeria) language"
Yao (Africa) language	yao	0	su:"Yao (Africa) language"
Yerava language	yea	0	su:"Yerava language"
Yerukala language	yeu	0	su:"Yerukala language"
Hua (Papua New Guinea) language	ygr	0	su:"Hua (Papua New Guinea) language"
Jindjibandji language	yij	0	su:"Jindjibandji language"
Yasa language	yko	0	su:"Yasa language"
Yombe (Congo and Angola) language	yom	0	su:"Yombe (Congo and Angola) language"
Ijebu language	yor	0	su:"Ijebu language"
Forest Nenets language	yrk	0	su:"Forest Nenets language"
Deli language	zlm	0	su:"Deli language"
Sambas language	zlm	0	su:"Sambas language"
Margany language	zmc	0	su:"Margany language"
Maranungku language	zmr	0	su:"Maranungku language"
